0000000000000000000000000000000000000000000000000000000000000000000000000000000000000700000000700000000000000000000000000000000000000000000000000000000000000000000007000000000000070000000000000000000000000000000000000000000000000000000000000000
0000000000000000000000000000000000000000000000000000000000000000000000000000000000000700000000700000000000000000000000000000000000000000000000000000000000000000000007000000000000070000000000000000000000000000000000000000000000000000100000000000
0000000000000000000000000000000000000000000000000000000000000000000000000000000000000700000000700000000000000000000000000000000000000000000000000000000000000000000007000000000000070000000000000000000000000000000000000000000000000040110000000000
0000000000000000000000000000000000000000000000000000000000000000000000000000000000000700000000700000000000000000000000000000000000000000000000000000000000000000000007000000000000070000000000000000000000000000000000000000000051111111111111111115
00000000000000000000000000000000000000000000000000000000000000000000000000000000000007000000007000000000000000000000000000000000000000000000000000000000000000000000070000000000000700000000000000000000000000000000000000000000w0000000000000000002
00000000000000000000000000000000000000000000000000000000000000000000000000000000000007000000007000000000000000000000000000000000000000000000000000000000000000000000070000000000000700000000000000000000000000000000000000000000wTTTETTTTTTTTTTTTTT2
0000000000000000000000000000000000000000000000000000000000000000000000000000000000000700000000700000000000000000000000000000000000000000000000000000000000000000000007000000000000070000000000000000000000000000000000000000000031111111111111111112
00000000000000000000000000000000000000000000000000000000000000000000000000000000000007000000007000000000000000000000000000000000000000000000000000000000000000000000070000000000000700000000000000000000000000000000000000000000w0000000000000000002
00000000000000000000000000000000000000000000000000000000000000000000000000000000000007000000007000000000000000000000000000000000000000000000000000000000000000000000070000000000000700000000000000000000000000000000000000000000wTTTTTTTTETTTTTTTTT2
0000000000000000000000000000000000000000000000000000000000000000000000000000000000000700000000700000000000000000000000000000000000000000000000000000000000000000000007000000000000070000000000000000000000000000000000000000000031111111111111111112
00000000000000000000000000000000000000000000000000000000000000000000000000000000000007000000007000000000000000000000000000000000000000000000000000000000000000000000070000000000000700000000000000000000000000000000000000000000w0000000000000000002
00000000000000000000000000000000000000000000000000000000000000000000000000000000000007000000007000000000000000000000000000000000000000000000000000000000000000000000070000000000000700000000000000000000000000000000000000000000wTTTTTTTTTTTETTTTTT2
0000000000000000000000000000000000000000000000000000000000000000000000000000000000000700000000700000000000000000000000000000000000000000000000000000000000000000000007000000000000070000000000000000000000000000000000000000000031111111111111111112
00000000000000000000000000000000000000000000000000000000000000000000000000000000000007000000007000000000000000000000000000000000000000000000000000000000000000000000070000000000000700000000000000000000000000000000000000000000w0000000000000000002
00000000000000000000000000000000000000000000000000000000000000000000000000000000000007000000007000000000000000000000000000000000000000000000000000000000000000000000070000000000000700000000000000000000000000000000000000000000wTTTTTTTTETTTTTTTTT2
0000000000000000000000000000000000000000000000000000000000000000000000000000000000000700000000700000000000000000000000000000000000000000000000000000000000000000000007000000000000070000000000000000000000000000000000000000000031111111111111111112
00000000000000000000000000000000000000000000000000000000000000000000000000000000000007000000007000000000000000000000000000000000000000000000000000000000000000000000070000000000000700000000000000000000000000000000000000000000w0000000000000000002
00000000000000000000000000000000000000000000000000000000000000000000000000000000000007000000007000000000000000000000000000000000000000000000000000000000000000000000070000000000000700000000000000000000000000000000000000000000wTTTTETTTTTTTTTTTTT2
0000000000000000000000000000000000000000000000000000000000000000000000000000000000000700000000700000000000000000000000000000000000000000000000000000000000000000000007000000000000070000000000000000000000000000000000000000000031111111111111111112
00000000000000000000000000000000000000000000000000000000000000000000000000000000000007000000007000000000000000000000000000000000000000000000000000000000000000000000070000000000000700000000000000000000000000000000000000000000w0000000000000000002
00000000000000000000000000000000000000000000000000000000000000000000000000000000000007000000007000000000000000000000000000000000000000000000000000000000000000000000070000000000000700000000000000000000000000000000000000000000wTETTTTTTTTTTTTTTTT2
0000000000000000000000000000000000000000000000000000000000000000000000000000000000000700000000700000000000000000000000000000000000000000000000000000000000000000000007000000000000070000000000000000000000000000000000000000000031111111111111111112
0000000000000000000000000000000000000000000000000000000000000000000000000000000000000700000000700000000000s000000000000000000000000000000000000000000000000000000000070000000000000700000000000000000000000000000000000000000000w0000000000000000002
00000000000000000000000000000000000000000000000000000000000000000000000000000000000007000000007000000000011111111111111100000000000000000000000000000000000000000000070000000000000700000000000000000000000000000000000000000000wTTTTTTTTTTTTTTTTET2
000000000000000000000000000000000000000000000000000000000000000000000000000000000000070000000070000000000d0000000000000d0000000000000000000000000000000000000000000007000000000000070000000000000000000000000000000000000000000031111111111111111112
000000000000000000000000000000000000000000000000000000000000000000000000000000000000070000000070000000000d0000000000000d00000000000000000000000000000000000000000000070000000000000700000000000000000000000000000000000000000000w0000000000000000002
00000000000000000000000000000000000000000000000000000000000000000000000000000000000001111111111000000000011111111111111100000000000000000000000000000000000000000000070000000000000700000000000000000000000000000000000000000000wTTTTTETTTTTTTTTTTT2
0000000000000000000000000000000000000000000000000000000000000000000000000000000000000d00000000d0000000000d0000000000000d0000000000000000000000000000000000000000000001111111111111110000000000000000000000000000000000000000000031111111111111111112
0000000000000000000000000000000000000000000000000000000000000000000000000000000000000d00000000d0000000000d0000000000000d000000000000000000000000000000000000000000000d0000000000000d0000000000000000000000000000000000000000000035555555555555555552
000000000000000000000000000000000000000000000000000000000000000000000000000000000000011111111110000000000111111111111111000000000000000000000000000000000000000000000d0000000000000d0000000000000000000000000000000000000000000035555555555555555552
000000000000000000000000000000000000000000000000000000000000000000000000000000000000000000000000000000000d0000000000000d0000000000000000000000000000000000000000000001111111111111110000000000000000000000000000000000000000000035555555555555555552
000000P00000000000000000000000000000000000000000000000000000000000000000000000000s00000000000000000000000d000000000TTETdTTTTT0000000000000000000000000000000000000000000000000000000000000000000000000000000000000000TTTTTETT00035555555555555555552
1111111111111110000000000111111111100000000000000000000111111111100000000001111111111000000000011111111111111111111111111111100000000001111111111111111111100000000000000000000000000000000001111111111000000000011111111111111135555555555555555552
3555555555555520000000000355555555200000000000000000000355555555200000000003555555552000000000035555555555555555555555555555200000000003555555555555555555200000000000000000000000000000000003555555552000000000035555555555555555555555555555555552
3555555555555520000000000355555555200000000000000000000355555555200000000003555555552000000000035555555555555555555555555555200000000003555555555555555555200000000001111111111111110000000003555555552000000000035555555555555555555555555555555552
3555555555555520000000000355555555200000000000000000000355555555200000000003555555552000000000035555555555555555555555555555200000000003555555555555555555200000000003555555555555520000000003555555552000000000035555555555555555555555555555555552