51111111111111111111111111111111111111111111111111111111111111111111111111111111111111111111111111111111111111111111111116
3000000000000000000z0000000000000000000000000000000000000000000000000000000000000000000000000000000000000000000000n0000002
30000000000000000000000000000000000000000000000000000000000000000000000000000000000000000000000000000000000000000000000002
300000000000000000000000000000000000000000000000000000000000000000000uuuu0000000000000000000000000000000000000000000000002
3000000P000000000000000000000uu00000000000000000000000000000000000000uuuu00000000000000000000000000000kkk00000000000000002
30000000000000000B0000000000Buu00000TTTTTTTTTTTTTTETTTTTTTTTTTTTTTT00uuuu000000000TTTTETTTT00000000000jjj00000000000000002
37777777777777777777777777777777777777777777777777777777777777777777777777777777777777777777777777777777777777777777700002
3000000000n000000000000000000000000000000000000000000000z0000000000000000000000000000000000000000000000000n000000000000002
30000000000000000000000000000000000000000000000000000000000000000000000000000000000000000000000000000000000000000000000002
30000000000000000000000000000000000000000000000000000000000000000000000000000000000000000000000000000000000000000000000002
3000000jj00000000000000000000000000000000000000000000000000000000000000000000000000000000000000000000000000000000000000002
3000000jj000000000000TTTTTTETTTTTT00000000jkjkjkjkjkjkjkjkjkjkjkjjkjkjkj00000TTTTTTTTTTTTTETTTTTTTTTTT00000000000000000002
30000777777777777777777777777777777777777777777777777777777777777777777777777777777777777777777777777777777777777777777772
300000000000000000000000000000n000000000000000n00000000n000000000n000000n0000000n0000000000000z000000000000000000000000002
30000000000000000000000000000000000000000000000000000000000000000000000000000000000000000000000000000000000000000000000002
300000000000000000uu00000000000000000000000000000000000000000000000000000000000000uuuuuu00000000000000000000000000000000x2
300000000000000000uu000000000000000000a00000000a000000000000a000000a00000a00000000uuuuuu0000000000000000000000000000000002
37777777777777777777777777777777777777777777777777777777777777777777777777777777777777777777777777777777777777777777000002
30000000000000000000000000000n0000000000000000000000000000000000000000000000000000000000z000000000000000000000000000000002
30000000000000000000000000000000000000000000000000000000000000000000000000000000000000000000000000000000000000000000000002
3000000000000000000000000000uuu00000000000000000000000000000000000000uuu00000000000000000000000000000000000000000000000002
300000000000TTTTTETTTTTTTTTTuuuTTTETTTTTTTTTTTETTTTTTTTTTTETTTTTTTTTTuuuTTTTTTTETTTTTTTuuuTTTTTTTTTTTTTETTTTTTTTT000000002
3v000077777777777777777777777777777777777777777777777777777777777777777777777777777777777777777777777777777777777777777772
3000000000000000z000000000000000000000z000000000000000000z000000000000000000000000000n0000000000000000000000n0000000000002
30000000000000000000000000000000000000000000000000000000000000000000000000000000000000000000000000000000000000000000000002
30000000000000000000000000000000000000000000000000000000000000000000000000000000000000000000000000000000000000000000000002
300000000000000000000000000000TTTTTETTTT00000000000000000000000000TTTTETTTTT0000000000000000000a00000000000000000000000002
37777777777777777777777777777777777777777777777777777777777777777777777777777777777777777777777777777777777777777777000002
3000000000000000z000000000000000000000000000000000000000000000n00000000000000000000000000000000000000000000000000000000002
300000000000000000000000000000000000000000000000000000000000000000000000000000000000000000000000000000000000000000000000x2
3000000000000000000000000uuuk0000000000000000000000kkkkk0000000000000k0000000000000000jjjjv000000000000000uu00000000000002
3000000000000000000000000uuuk00000TTTTTTTETTT000000kkkkk000000000000jk00TTTTETTTTTT000jjjj0000000000000000uu00000000000002
30000000000077777777777777777777777777777777777777777777777777777777777777777777777777777777777777777777777777777777777772
300000000000000uuuuuu0000000n000000000000000uuuu00000000000000000000muf000000000000000000000000000000000000000n00000000002
300000000000000uuuuuuuuuu000000uuuu000000000uuuu0000000000000000uuuuuuuuuuu00000000000000000000000000000000000000000000002
30000000000000000000000000000000000000uuu0000000000000jkj00000000000000000000000u0000000000000000000kjk0000000000000000002
3000000000uuu0000000000000uu000000000uuuu0000000000000jkj000000000000000000000uuu0000TTTTTTETTTTTT00kjk0000000000000000002
37777777777777777777777777777777777777777777777777777777777777777777777777777777777777777777777777777777777777777777000002
30000000000000000000000000000000000000000000000000000000000000000000000000000000000000000000000000000000000000000000000002
30000000000000000000000000000000000000000000uu00000000000000000000000000000000000000000000000000uu000000000000000000000002
30000000000000000000000000000000000u000000000000000uu0000000000000000000uuu00000000uu0000000u0000000000000000000000uuuuuu2
3000000000u00000000000000000000000000000000000000000000000000000000000000000000000000000000000000000000000000u000000000002
300000000uu000000000000uuu00000000000u00000000u000000000uu000000u000000000000000000000000uu0000000000000000000000000000002
3000000000000000000000000000000u000000000000000u000000000000000000000000uuu000000000000000000000000000uu000000000000000002
3000000jk0000000uu00000000000000000000000000000000000uuu00000000000000000000000000000000000000uu00000000000000000000000002
3000000uu00000000000000000000000000000000000000000000000000000000000000000000000000000000000000000000000000000000000000002
300s000uuTTTTTTETTTTTTTTTETTTTTTTTETTTTTTTTTETTTTTTTTTTTTTTTTETTTTTTTTTTTTTETTTTTTTTTTTTTETTTTTTTTTTTTTETTTTTTTTTETTTTTTT2
37777777777777777777777777777777777777777777777777777777777777777777777777777777777777777777777777777777777777777777777772
30000000000000000000000000000000000000000000000000000000000000000000000000000000000000000000000000000000000000000000000002
30000000000000000000000000000000000000000000000000000000000000000000000000000000000000000000000000000000000000000000000002
30000000000000000000000000000000000000000000000000000000000000000000000000000000000000000000000000000000000000000000000002
30000000000000000000000000000000000000000000000000000000000000000000000000000000000000000000000000000000000000000000000002
30000000000000000000000000000000000000000000000000000000000000000000000000000000000000000000000000000000000000000000000002
30000000000000000000000000000000000000000000000000000000000000000000000000000000000000000000000000000000000000000000000002
30000000000000000000000000000000000000000000000000000000000000000000000000000000000000000000000000000000000000000000000002
30000000000000000000000000000000000000000000000000000000000000000000000000000000000000000000000000000000000000000000000002
30000000000000000000000000000000000000000000000000000000000000000000000000000000000000000000000000000000000000000000000002
30000000000000000000000000000000000000000000000000000000000000000000000000000000000000000000000000000000000000000000000002
30000000000000000000000000000000000000000000000000000000000000000000000000000000000000000000000000000000000000000000000002
30000000000000000000000000000000000000000000000000000000000000000000000000000000000000000000000000000000000000000000000002
30000000000000000000000000000000000000000000000000000000000000000000000000000000000000000000000000000000000000000000000002
30000000000000000000000000000000000000000000000000000000000000000000000000000000000000000000000000000000000000000000000002