0000000000000000000000000000000000000000000000000000000000000000000000000000000000000b00000000b0000000000000000000000000000000000000000000000000000000000000000000000b0000000000000b0000000000000000000000000000000000000000000000000000000000000000
0000000000000000000000000000000000000000000000000000000000000000000000000000000000000b00000000b0000000000000000000000000000000000000000000000000000000000000000000000b0000000000000b0000000000000000000000000000000000000000000000000000000000000000
0000000000000000000000000000000000000000000000000000000000000000000000000000000000000b00000000b0000000000000000000000000000000000000000000000000000000000000000000000b0000000000000b0000000000000000000000000000000000000000000000000000000000000000
0000000000000000000000000000000000000000000000000000000000000000000000000000000000000b00000000b0000000000000000000000000000000000000000000000000000000000000000000000b0000000000000b0000000000000000000000000000000000000000000000000000000000000000
0000000000000000000000000000000000000000000000000000000000000000000000000000000000000b00000000b0000000000000000000000000000000000000000000000000000000000000000000000b0000000000000b0000000000000000000000000000000000000000000000000000000000000000
0000000000000000000000000000000000000000000000000000000000000000000000000000000000000b00000000b0000000000000000000000000000000000000000000000000000000000000000000000b0000000000000b0000000000000000000000000000000000000000000000000000000000000000
0000000000000000000000000000000000000000000000000000000000000000000000000000000000000b00000000b0000000000000000000000000000000000000000000000000000000000000000000000b0000000000000b0000000000000000000000000000000000000000000000000000000000000000
0000000000000000000000000000000000000000000000000000000000000000000000000000000000000b00000000b0000000000000000000000000000000000000000000000000000000000000000000000b0000000000000b0000000000000000000000000000000000000000000000000000000000000000
0000000000000000000000000000000000000000000000000000000000000000000000000000000000000b00000000b0000000000000000000000000000000000000000000000000000000000000000000000b0000000000000b0000000000000000000000000000000000000000000000000000000000000000
0000000000000000000000000000000000000000000000000000000000000000000000000000000000000b00000000b0000000000000000000000000000000000000000000000000000000000000000000000b0000000000000b0000000000000000000000000000000000000000000000000000000000000000
0000000000000000000000000000000000000000000000000000000000000000000000000000000000000b00000000b0000000000000000000000000000000000000000000000000000000000000000000000b0000000000000b0000000000000000000000000000000000000000000000000000000000000000
0000000000000000000000000000000000000000000000000000000000000000000000000000000000000b00000000b0000000000000000000000000000000000000000000000000000000000000000000000b0000000000000b0000000000000000000000000000000000000000000000000000000000000000
0000000000000000000000000000000000000000000000000000000000000000000000000000000000000b00000000b0000000000000000000000000000000000000000000000000000000000000000000000b0000000000000b0000000000000000000000000000000000000000000000000000000000000000
0000000000000000000000000000000000000000000000000000000000000000000000000000000000000b00000000b0000000000000000000000000000000000000000000000000000000000000000000000b0000000000000b0000000000000000000000000000000000000000000000000000000000000000
0000000000000000000000000000000000000000000000000000000000000000000000000000000000000b00000000b0000000000000000000000000000000000000000000000000000000000000000000000b0000000000000b00000000000000000000000000000000000000000000000P0000000000000000
0000000000000000000000000000000000000000000000000000000000000000000000000000000000000b00000000b0000000000000000000000000000000000000000000000000000000000000000000000b0000000000000b0000000000000000000000000000000000000000000000000000910000000000
0000000000000000000000000000000000000000000000000000000000000000000000000000000000000b00000000b0000000000000000000000000000000000000000000000000000000000000000000000b0000000000000b0000000000000000000000000000000000000000000051111111111111111116
0000000000000000000000000000000000000000000000000000000000000000000000000000000000000b00000000b0000000000000000000000000000000000000000000000000000000000000000000000b0000000000000b0000000000000000000000000000000000000000000080000000000000000002
0000000000000000000000000000000000000000000000000000000000000000000000000000000000000b00000000b0000000000000000000000000000000000000000000000000000000000000000000000b0000000000000b000000000000000000000000000000000000000000008TTTETTTTTTTTTTTTTT2
0000000000000000000000000000000000000000000000000000000000000000000000000000000000000b00000000b0000000000000000000000000000000000000000000000000000000000000000000000b0000000000000b0000000000000000000000000000000000000000000011111111111111111112
0000000000000000000000000000000000000000000000000000000000000000000000000000000000000b00000000b0000000000000000000000000000000000000000000000000000000000000000000000b0000000000000b0000000000000000000000000000000000000000000080000000000000000002
0000000000000000000000000000000000000000000000000000000000000000000000000000000000000b00000000b0000000000000000000000000000000000000000000000000000000000000000000000b0000000000000b000000000000000000000000000000000000000000008TTTTTTTTETTTTTTTTT2
0000000000000000000000000000000000000000000000000000000000000000000000000000000000000b00000000b0000000000000000000000000000000000000000000000000000000000000000000000b0000000000000b0000000000000000000000000000000000000000000011111111111111111112
0000000000000000000000000000000000000000000000000000000000000000000000000000000000000b00000000b0000000000000000000000000000000000000000000000000000000000000000000000b0000000000000b0000000000000000000000000000000000000000000080000000000000000002
0000000000000000000000000000000000000000000000000000000000000000000000000000000000000b00000000b0000000000000000000000000000000000000000000000000000000000000000000000b0000000000000b000000000000000000000000000000000000000000008TTTTTTTTTTTETTTTTT2
0000000000000000000000000000000000000000000000000000000000000000000000000000000000000b00000000b0000000000000000000000000000000000000000000000000000000000000000000000b0000000000000b0000000000000000000000000000000000000000000011111111111111111112
0000000000000000000000000000000000000000000000000000000000000000000000000000000000000b00000000b0000000000000000000000000000000000000000000000000000000000000000000000b0000000000000b0000000000000000000000000000000000000000000080000000000000000002
0000000000000000000000000000000000000000000000000000000000000000000000000000000000000b00000000b0000000000000000000000000000000000000000000000000000000000000000000000b0000000000000b000000000000000000000000000000000000000000008TTTTTTTTETTTTTTTTT2
0000000000000000000000000000000000000000000000000000000000000000000000000000000000000b00000000b0000000000000000000000000000000000000000000000000000000000000000000000b0000000000000b0000000000000000000000000000000000000000000011111111111111111112
0000000000000000000000000000000000000000000000000000000000000000000000000000000000000b00000000b0000000000000000000000000000000000000000000000000000000000000000000000b0000000000000b0000000000000000000000000000000000000000000080000000000000000002
0000000000000000000000000000000000000000000000000000000000000000000000000000000000000b00000000b0000000000000000000000000000000000000000000000000000000000000000000000b0000000000000b000000000000000000000000000000000000000000008TTTTETTTTTTTTTTTTT2
0000000000000000000000000000000000000000000000000000000000000000000000000000000000000b00000000b0000000000000000000000000000000000000000000000000000000000000000000000b0000000000000b0000000000000000000000000000000000000000000011111111111111111112
0000000000000000000000000000000000000000000000000000000000000000000000000000000000000b00000000b0000000000000000000000000000000000000000000000000000000000000000000000b0000000000000b0000000000000000000000000000000000000000000080000000000000000002
0000000000000000000000000000000000000000000000000000000000000000000000000000000000000b00000000b000000000000000000000k000000000000000000000000000000000000000000000000b0000000000000b000000000000000000000000000000000000000000008TETTTTTTTTTTTTTTTT2
0000000000000000000000000000000000000000000000000000000000000000000000000000000000000b00000000b000000000000P00000jk0j000000000000000000000000000000000000000000000000b0000000000000b0000000000000000000000000000000000000000000011111111111111111112
0000000000000000000000000000000000000000000000000000000000000000000000000000000000000b00000000b000000000000000FGGjjjjGGH000000000000000000000000000000000000000000000b0000000000000br000000000000000000000000000000000000000000080000000000000000002
0000000000000000000000000000000000000000000000000000000000000000000000000000000000000b00000000b0000000000511111111111116000000000000000000000000000000000000000000000b0000000000000br00000000000000000000000000000000000000000008TTTTTTTTTTTTTTTTET2
0000000000000000000000000000000000000000000000000000000000000000000000000000000000000b00000000b0000000000900000000000009000000000000000000000000000000000000000000000b0000000000000br000000000000000000000000000000000000000000011111111111111111112
0000000000000000000000000000000000000000000000000000000000000000000000000000000000000b00000000b0000000000900000000000009000000000000000000000000000000000000000000000b000000000k000br000000000000000000000000000000000000000000080000000000000000002
000000000000000000000000000000000000000000000000000000000000000000000000000000000000051111111160000000000511111111111116000000000000000000000000000000000000000000000b00000000kk000br00000000000000000000000000000000000000000008TTTTTETTTTTTTTTTTT2
000000000000000000000000000000000000000000000000000000000000000000000000000000000000090000000090000000000d0000000000000dr00000000000000000000000000000000000000000000511111111111116r000000000000000000000000000000000000000000011111111111111111112
000000000000000000000000000000000000000000000000000000000000000000000000000000000000090000000090000000000d0000000000000dr00000000000000000000000000000000000000000000d0000000000000dr000000000000000000000000000000000000000000037777777777777777772
00000000000000000000000000000000000000000000000000000000000000000000000000000uu0000005111111116000000000051111111111111600000000000000000000000000000uuu0000000000000d0000000000000dr000000000000000000000000000000000000000000037777777777777777772
00Q0000000000000000000000000000jk000000000000000000000000k0000000000000000000uu00000000000000000000uu0000D000000000000090000000000000000000000000j000uuu0000000000000511111111111116r00000000000000k000000000000000000000000000037777777777777777772
00000000kj000000000000000FGGGGGjkH00000000000000000000000jj000000000000000000uu00000000000000000FGGuuGGH0D000000s00TTET9TTT0000000000000000FGGGGkjH00uuu0s00000000000000000000000000r000000000uu000k00000000000000000TTTTTETT00037777777777777777772
511111111111116000000000051111111160000000001110000000051111111160000000000511111111600000000005111111111111111111111111111160000000000511111111111111111160000000000000000000000000r000000005111111116000000000051111111111111177777777777777777772
377777777777772000000000037777777720000000000000000000037777777720000000000377777777200000000003777777777777777777777777777720000000000377777777777777777720000000000000j00FGGGGGGH0r000000003777777772000000000037777777777777777777777777777777772
3777777777777720000000000377777777200000000000000000000377777777200000000003777777772000000000037777777777777777777777777777200000000003777777777777777777200000000005111111111111160000000003777777772000000000037777777777777777777777777777777772
3777777777777720000000000377777777200000000000000000000377777777200000000003777777772000000000037777777777777777777777777777200000000003777777777777777777200000000003777777777777720000000003777777772000000000037777777777777777777777777777777772
3777777777777720000000000377777777200000000000000000000377777777200000000003777777772000000000037777777777777777777777777777200000000003777777777777777777200000000003777777777777720000000003777777772000000000037777777777777777777777777777777772
3777777777777720000000000377777777200000000000000000000377777777200000000003777777772000000000037777777777777777777777777777200000000003777777777777777777200000000003777777777777720000000003777777772000000000037777777777777777777777777777777772
3777777777777720000000000377777777200000000000000000000377777777200000000003777777772000000000037777777777777777777777777777200000000003777777777777777777200000000003777777777777720000000003777777772000000000037777777777777777777777777777777772
3777777777777720000000000377777777200000000000000000000377777777200000000003777777772000000000037777777777777777777777777777200000000003777777777777777777200000000003777777777777720000000003777777772000000000037777777777777777777777777777777772
3777777777777720000000000377777777200000000000000000000377777777200000000003777777772000000000037777777777777777777777777777200000000003777777777777777777200000000003777777777777720000000003777777772000000000037777777777777777777777777777777772
3777777777777720000000000377777777200000000000000000000377777777200000000003777777772000000000037777777777777777777777777777200000000003777777777777777777200000000003777777777777720000000003777777772000000000037777777777777777777777777777777772
3777777777777720000000000377777777200000000000000000000377777777200000000003777777772000000000037777777777777777777777777777200000000003777777777777777777200000000003777777777777720000000003777777772000000000037777777777777777777777777777777772
3777777777777720000000000377777777200000000000000000000377777777200000000003777777772000000000037777777777777777777777777777200000000003777777777777777777200000000003777777777777720000000003777777772000000000037777777777777777777777777777777772
3777777777777720000000000377777777200000000000000000000377777777200000000003777777772000000000037777777777777777777777777777200000000003777777777777777777200000000003777777777777720000000003777777772000000000037777777777777777777777777777777772
3777777777777720000000000377777777200000000000000000000377777777200000000003777777772000000000037777777777777777777777777777200000000003777777777777777777200000000003777777777777720000000003777777772000000000037777777777777777777777777777777772
3777777777777720000000000377777777200000000000000000000377777777200000000003777777772000000000037777777777777777777777777777200000000003777777777777777777200000000003777777777777720000000003777777772000000000037777777777777777777777777777777772
3777777777777720000000000377777777200000000000000000000377777777200000000003777777772000000000037777777777777777777777777777200000000003777777777777777777200000000003777777777777720000000003777777772000000000037777777777777777777777777777777772
3777777777777720000000000377777777200000000000000000000377777777200000000003777777772000000000037777777777777777777777777777200000000003777777777777777777200000000003777777777777720000000003777777772000000000037777777777777777777777777777777772
3777777777777720000000000377777777200000000000000000000377777777200000000003777777772000000000037777777777777777777777777777200000000003777777777777777777200000000003777777777777720000000003777777772000000000037777777777777777777777777777777772
3777777777777720000000000377777777200000000000000000000377777777200000000003777777772000000000037777777777777777777777777777200000000003777777777777777777200000000003777777777777720000000003777777772000000000037777777777777777777777777777777772
3777777777777720000000000377777777200000000000000000000377777777200000000003777777772000000000037777777777777777777777777777200000000003777777777777777777200000000003777777777777720000000003777777772000000000037777777777777777777777777777777772
3777777777777720000000000377777777200000000000000000000377777777200000000003777777772000000000037777777777777777777777777777200000000003777777777777777777200000000003777777777777720000000003777777772000000000037777777777777777777777777777777772
3777777777777720000000000377777777200000000000000000000377777777200000000003777777772000000000037777777777777777777777777777200000000003777777777777777777200000000003777777777777720000000003777777772000000000037777777777777777777777777777777772
3777777777777720000000000377777777200000000000000000000377777777200000000003777777772000000000037777777777777777777777777777200000000003777777777777777777200000000003777777777777720000000003777777772000000000037777777777777777777777777777777772
3777777777777720000000000377777777200000000000000000000377777777200000000003777777772000000000037777777777777777777777777777200000000003777777777777777777200000000003777777777777720000000003777777772000000000037777777777777777777777777777777772