0000000000000000000000000000000000000000000000000000000000000000000000000000000000000b00000000b0000000000000000000000000000000000000000000000000000000000000000000000b0000000000000b0000000000000000000000000000000000000000000000000000000000000000
0000000000000000000000000000000000000000000000000000000000000000000000000000000000000b00000000b0000000000000000000000000000000000000000000000000000000000000000000000b0000000000000b0000000000000000000000000000000000000000000000000000000000000000
0000000000000000000000000000000000000000000000000000000000000000000000000000000000000b00000000b0000000000000000000000000000000000000000000000000000000000000000000000b0000000000000b0000000000000000000000000000000000000000000000000000000000000000
0000000000000000000000000000000000000000000000000000000000000000000000000000000000000b00000000b0000000000000000000000000000000000000000000000000000000000000000000000b0000000000000b0000000000000000000000000000000000000000000000000000000000000000
0000000000000000000000000000000000000000000000000000000000000000000000000000000000000b00000000b0000000000000000000000000000000000000000000000000000000000000000000000b0000000000000b0000000000000000000000000000000000000000000000000000000000000000
0000000000000000000000000000000000000000000000000000000000000000000000000000000000000b00000000b0000000000000000000000000000000000000000000000000000000000000000000000b0000000000000b0000000000000000000000000000000000000000000000000000000000000000
0000000000000000000000000000000000000000000000000000000000000000000000000000000000000b00000000b0000000000000000000000000000000000000000000000000000000000000000000000b0000000000000b0000000000000000000000000000000000000000000000000000000000000000
0000000000000000000000000000000000000000000000000000000000000000000000000000000000000b00000000b0000000000000000000000000000000000000000000000000000000000000000000000b0000000000000b0000000000000000000000000000000000000000000000000000000000000000
0000000000000000000000000000000000000000000000000000000000000000000000000000000000000b00000000b0000000000000000000000000000000000000000000000000000000000000000000000b0000000000000b0000000000000000000000000000000000000000000000000000000000000000
0000000000000000000000000000000000000000000000000000000000000000000000000000000000000b00000000b0000000000000000000000000000000000000000000000000000000000000000000000b0000000000000b0000000000000000000000000000000000000000000000000000000000000000
0000000000000000000000000000000000000000000000000000000000000000000000000000000000000b00000000b0000000000000000000000000000000000000000000000000000000000000000000000b0000000000000b0000000000000000000000000000000000000000000000000000000000000000
0000000000000000000000000000000000000000000000000000000000000000000000000000000000000b00000000b0000000000000000000000000000000000000000000000000000000000000000000000b0000000000000b0000000000000000000000000000000000000000000000000000000000000000
0000000000000000000000000000000000000000000000000000000000000000000000000000000000000b00000000b0000000000000000000000000000000000000000000000000000000000000000000000b0000000000000b0000000000000000000000000000000000000000000000000000000000000000
0000000000000000000000000000000000000000000000000000000000000000000000000000000000000b00000000b0000000000000000000000000000000000000000000000000000000000000000000000b0000000000000b0000000000000000000000000000000000000000000000000000000000000000
0000000000000000000000000000000000000000000000000000000000000000000000000000000000000b00000000b0000000000000000000000000000000000000000000000000000000000000000000000b0000000000000b0000000000000000000000000000000000000000000000000000100000000000
0000000000000000000000000000000000000000000000000000000000000000000000000000000000000b00000000b0000000000000000000000000000000000000000000000000000000000000000000000b0000000000000b0000000000000000000000000000000000000000000000000000D10000000000
0000000000000000000000000000000000000000000000000000000000000000000000000000000000000b00000000b0000000000000000000000000000000000000000000000000000000000000000000000b0000000000000b0000000000000000000000000000000000000000000051111111111111111116
0000000000000000000000000000000000000000000000000000000000000000000000000000000000000b00000000b0000000000000000000000000000000000000000000000000000000000000000000000b0000000000000b0000000000000000000000000000000000000000000080000000000000000002
0000000000000000000000000000000000000000000000000000000000000000000000000000000000000b00000000b0000000000000000000000000000000000000000000000000000000000000000000000b0000000000000b000000000000000000000000000000000000000000008TTTETTTTTTTTTTTTTT2
0000000000000000000000000000000000000000000000000000000000000000000000000000000000000b00000000b0000000000000000000000000000000000000000000000000000000000000000000000b0000000000000b0000000000000000000000000000000000000000000011111111111111111112
0000000000000000000000000000000000000000000000000000000000000000000000000000000000000b00000000b0000000000000000000000000000000000000000000000000000000000000000000000b0000000000000b0000000000000000000000000000000000000000000080000000000000000002
0000000000000000000000000000000000000000000000000000000000000000000000000000000000000b00000000b0000000000000000000000000000000000000000000000000000000000000000000000b0000000000000b000000000000000000000000000000000000000000008TTTTTTTTETTTTTTTTT2
0000000000000000000000000000000000000000000000000000000000000000000000000000000000000b00000000b0000000000000000000000000000000000000000000000000000000000000000000000b0000000000000b0000000000000000000000000000000000000000000011111111111111111112
0000000000000000000000000000000000000000000000000000000000000000000000000000000000000b00000000b0000000000000000000000000000000000000000000000000000000000000000000000b0000000000000b0000000000000000000000000000000000000000000080000000000000000002
0000000000000000000000000000000000000000000000000000000000000000000000000000000000000b00000000b0000000000000000000000000000000000000000000000000000000000000000000000b0000000000000b000000000000000000000000000000000000000000008TTTTTTTTTTTETTTTTT2
0000000000000000000000000000000000000000000000000000000000000000000000000000000000000b00000000b0000000000000000000000000000000000000000000000000000000000000000000000b0000000000000b0000000000000000000000000000000000000000000011111111111111111112
0000000000000000000000000000000000000000000000000000000000000000000000000000000000000b00000000b0000000000000000000000000000000000000000000000000000000000000000000000b0000000000000b0000000000000000000000000000000000000000000080000000000000000002
0000000000000000000000000000000000000000000000000000000000000000000000000000000000000b00000000b0000000000000000000000000000000000000000000000000000000000000000000000b0000000000000b000000000000000000000000000000000000000000008TTTTTTTTETTTTTTTTT2
0000000000000000000000000000000000000000000000000000000000000000000000000000000000000b00000000b0000000000000000000000000000000000000000000000000000000000000000000000b0000000000000b0000000000000000000000000000000000000000000011111111111111111112
0000000000000000000000000000000000000000000000000000000000000000000000000000000000000b00000000b0000000000000000000000000000000000000000000000000000000000000000000000b0000000000000b0000000000000000000000000000000000000000000080000000000000000002
0000000000000000000000000000000000000000000000000000000000000000000000000000000000000b00000000b0000000000000000000000000000000000000000000000000000000000000000000000b0000000000000b000000000000000000000000000000000000000000008TTTTETTTTTTTTTTTTT2
0000000000000000000000000000000000000000000000000000000000000000000000000000000000000b00000000b0000000000000000000000000000000000000000000000000000000000000000000000b0000000000000b0000000000000000000000000000000000000000000011111111111111111112
0000000000000000000000000000000000000000000000000000000000000000000000000000000000000b00000000b0000000000000000000000000000000000000000000000000000000000000000000000b0000000000000b0000000000000000000000000000000000000000000080000000000000000002
0000000000000000000000000000000000000000000000000000000000000000000000000000000000000b00000000b0000000000000000000000000000000000000000000000000000000000000000000000b0000000000000b000000000000000000000000000000000000000000008TETTTTTTTTTTTTTTTT2
0000000000000000000000000000000000000000000000000000000000000000000000000000000000000b00000000b0000000000000000000000000000000000000000000000000000000000000000000000b0000000000000b0000000000000000000000000000000000000000000011111111111111111112
0000000000000000000000000000000000000000000000000000000000000000000000000000000000000b00000000b00000000000s0000000000000000000000000000000000000000000000000000000000b0000000000000b0000000000000000000000000000000000000000000080000000000000000002
0000000000000000000000000000000000000000000000000000000000000000000000000000000000000b00000000b0000000000511111111111116000000000000000000000000000000000000000000000b0000000000000b000000000000000000000000000000000000000000008TTTTTTTTTTTTTTTTET2
0000000000000000000000000000000000000000000000000000000000000000000000000000000000000b00000000b0000000000d0000000000000d000000000000000000000000000000000000000000000b0000000000000b0000000000000000000000000000000000000000000011111111111111111112
0000000000000000000000000000000000000000000000000000000000000000000000000000000000000b00000000b0000000000d0000000000000d000000000000000000000000000000000000000000000b0000000000000b0000000000000000000000000000000000000000000080000000000000000002
000000000000000000000000000000000000000000000000000000000000000000000000000000000000051111111160000000000511111111111116000000000000000000000000000000000000000000000b000000000k000b000000000000000000000000000000000000000000008TTTTTETTTTTTTTTTTT2
0000000000000000000000000000000000000000000000000000000000000000000000000000000000000d00000000d000000P000d0000000000000d0000000000000000000000000000000000000000000005111111111111160000000000000000000000000000000000000000000011111111111111111112
0000000000000000000000000000000000000000000000000000000000000000000000000000000000000d00000000d0000000000d0000000000000d000000000000000000000000000000000000000000000d0000000000000d0000000000000000000000000000000000000000000037777777777777777772
000000000000000000000000000000000000000000000000000000000000000000000000000000000000051111111160000000000511111111111116000000000000000000000000000000000000000000000d0000000000000d0000000000000000000000000000000000000000000037777777777777777772
000000000000000000000000000000000000000000000000000000000000000000000000000000000000000000000000000000000d0000000000000d0000000000000000000000000000000000000000000005111111111111160000000000000000000000000000000000000000000037777777777777777772
00000000kj0000000000000000000000k000000000000000000000000j00000000000000000000000s00000000000000000000000d000000000TTETdTTT000000000000000000000kj0000000000000000000000000000000000000000000000000k00000000000000000TTTTTETT00037777777777777777772
5111111111111160000000000511111111600000000000000000000511111111600000000005111111116000000000051111111111111111111111111111600000000005111111111111111111600000000000000000000000000000000005111111116000000000051111111111111177777777777777777772
377777777777772000000000037777777720000000000000000000037777777720000000000377777777200000000003777777777777777777777777777720000000000377777777777777777720000000000000j000000000000000000003777777772000000000037777777777777777777777777777777772
3777777777777720000000000377777777200000000000000000000377777777200000000003777777772000000000037777777777777777777777777777200000000003777777777777777777200000000005111111111111160000000003777777772000000000037777777777777777777777777777777772
3777777777777720000000000377777777200000000000000000000377777777200000000003777777772000000000037777777777777777777777777777200000000003777777777777777777200000000003777777777777720000000003777777772000000000037777777777777777777777777777777772
3777777777777720000000000377777777200000000000000000000377777777200000000003777777772000000000037777777777777777777777777777200000000003777777777777777777200000000003777777777777720000000003777777772000000000037777777777777777777777777777777772
3777777777777720000000000377777777200000000000000000000377777777200000000003777777772000000000037777777777777777777777777777200000000003777777777777777777200000000003777777777777720000000003777777772000000000037777777777777777777777777777777772
3777777777777720000000000377777777200000000000000000000377777777200000000003777777772000000000037777777777777777777777777777200000000003777777777777777777200000000003777777777777720000000003777777772000000000037777777777777777777777777777777772
3777777777777720000000000377777777200000000000000000000377777777200000000003777777772000000000037777777777777777777777777777200000000003777777777777777777200000000003777777777777720000000003777777772000000000037777777777777777777777777777777772
3777777777777720000000000377777777200000000000000000000377777777200000000003777777772000000000037777777777777777777777777777200000000003777777777777777777200000000003777777777777720000000003777777772000000000037777777777777777777777777777777772
3777777777777720000000000377777777200000000000000000000377777777200000000003777777772000000000037777777777777777777777777777200000000003777777777777777777200000000003777777777777720000000003777777772000000000037777777777777777777777777777777772
3777777777777720000000000377777777200000000000000000000377777777200000000003777777772000000000037777777777777777777777777777200000000003777777777777777777200000000003777777777777720000000003777777772000000000037777777777777777777777777777777772
3777777777777720000000000377777777200000000000000000000377777777200000000003777777772000000000037777777777777777777777777777200000000003777777777777777777200000000003777777777777720000000003777777772000000000037777777777777777777777777777777772
3777777777777720000000000377777777200000000000000000000377777777200000000003777777772000000000037777777777777777777777777777200000000003777777777777777777200000000003777777777777720000000003777777772000000000037777777777777777777777777777777772
3777777777777720000000000377777777200000000000000000000377777777200000000003777777772000000000037777777777777777777777777777200000000003777777777777777777200000000003777777777777720000000003777777772000000000037777777777777777777777777777777772
3777777777777720000000000377777777200000000000000000000377777777200000000003777777772000000000037777777777777777777777777777200000000003777777777777777777200000000003777777777777720000000003777777772000000000037777777777777777777777777777777772
3777777777777720000000000377777777200000000000000000000377777777200000000003777777772000000000037777777777777777777777777777200000000003777777777777777777200000000003777777777777720000000003777777772000000000037777777777777777777777777777777772
3777777777777720000000000377777777200000000000000000000377777777200000000003777777772000000000037777777777777777777777777777200000000003777777777777777777200000000003777777777777720000000003777777772000000000037777777777777777777777777777777772
3777777777777720000000000377777777200000000000000000000377777777200000000003777777772000000000037777777777777777777777777777200000000003777777777777777777200000000003777777777777720000000003777777772000000000037777777777777777777777777777777772
3777777777777720000000000377777777200000000000000000000377777777200000000003777777772000000000037777777777777777777777777777200000000003777777777777777777200000000003777777777777720000000003777777772000000000037777777777777777777777777777777772
3777777777777720000000000377777777200000000000000000000377777777200000000003777777772000000000037777777777777777777777777777200000000003777777777777777777200000000003777777777777720000000003777777772000000000037777777777777777777777777777777772
3777777777777720000000000377777777200000000000000000000377777777200000000003777777772000000000037777777777777777777777777777200000000003777777777777777777200000000003777777777777720000000003777777772000000000037777777777777777777777777777777772
3777777777777720000000000377777777200000000000000000000377777777200000000003777777772000000000037777777777777777777777777777200000000003777777777777777777200000000003777777777777720000000003777777772000000000037777777777777777777777777777777772
3777777777777720000000000377777777200000000000000000000377777777200000000003777777772000000000037777777777777777777777777777200000000003777777777777777777200000000003777777777777720000000003777777772000000000037777777777777777777777777777777772
3777777777777720000000000377777777200000000000000000000377777777200000000003777777772000000000037777777777777777777777777777200000000003777777777777777777200000000003777777777777720000000003777777772000000000037777777777777777777777777777777772