0000000000000000000000000000000000000000000000000000000000000000000000000000000000000700000000700000000000000000000000000000000000000000000000000000000000000000000007000000000000070000000000000000000000000000000000000000000000000000000000000000
0000000000000000000000000000000000000000000000000000000000000000000000000000000000000700000000700000000000000000000000000000000000000000000000000000000000000000000007000000000000070000000000000000000000000000000000000000000000000000100000000000
0000000000000000000000000000000000000000000000000000000000000000000000000000000000000700000000700000000000000000000000000000000000000000000000000000000000000000000007000000000000070000000000000000000000000000000000000000000000000040110000000000
0000000000000000000000000000000000000000000000000000000000000000000000000000000000000700000000700000000000000000000000000000000000000000000000000000000000000000000007000000000000070000000000000000000000000000000000000000000021111111111111111112
00000000000000000000000000000000000000000000000000000000000000000000000000000000000007000000007000000000000000000000000000000000000000000000000000000000000000000000070000000000000700000000000000000000000000000000000000000000w0000000000000000002
00000000000000000000000000000000000000000000000000000000000000000000000000000000000007000000007000000000000000000000000000000000000000000000000000000000000000000000070000000000000700000000000000000000000000000000000000000000wTTTETTTTTTTTTTTTTT2
0000000000000000000000000000000000000000000000000000000000000000000000000000000000000700000000700000000000000000000000000000000000000000000000000000000000000000000007000000000000070000000000000000000000000000000000000000000021111111111111111112
00000000000000000000000000000000000000000000000000000000000000000000000000000000000007000000007000000000000000000000000000000000000000000000000000000000000000000000070000000000000700000000000000000000000000000000000000000000w0000000000000000002
00000000000000000000000000000000000000000000000000000000000000000000000000000000000007000000007000000000000000000000000000000000000000000000000000000000000000000000070000000000000700000000000000000000000000000000000000000000wTTTTTTTTETTTTTTTTT2
0000000000000000000000000000000000000000000000000000000000000000000000000000000000000700000000700000000000000000000000000000000000000000000000000000000000000000000007000000000000070000000000000000000000000000000000000000000021111111111111111112
00000000000000000000000000000000000000000000000000000000000000000000000000000000000007000000007000000000000000000000000000000000000000000000000000000000000000000000070000000000000700000000000000000000000000000000000000000000w0000000000000000002
00000000000000000000000000000000000000000000000000000000000000000000000000000000000007000000007000000000000000000000000000000000000000000000000000000000000000000000070000000000000700000000000000000000000000000000000000000000wTTTTTTTTTTTETTTTTT2
0000000000000000000000000000000000000000000000000000000000000000000000000000000000000700000000700000000000000000000000000000000000000000000000000000000000000000000007000000000000070000000000000000000000000000000000000000000021111111111111111112
00000000000000000000000000000000000000000000000000000000000000000000000000000000000007000000007000000000000000000000000000000000000000000000000000000000000000000000070000000000000700000000000000000000000000000000000000000000w0000000000000000002
00000000000000000000000000000000000000000000000000000000000000000000000000000000000007000000007000000000000000000000000000000000000000000000000000000000000000000000070000000000000700000000000000000000000000000000000000000000wTTTTTTTTETTTTTTTTT2
0000000000000000000000000000000000000000000000000000000000000000000000000000000000000700000000700000000000000000000000000000000000000000000000000000000000000000000007000000000000070000000000000000000000000000000000000000000021111111111111111112
00000000000000000000000000000000000000000000000000000000000000000000000000000000000007000000007000000000000000000000000000000000000000000000000000000000000000000000070000000000000700000000000000000000000000000000000000000000w0000000000000000002
00000000000000000000000000000000000000000000000000000000000000000000000000000000000007000000007000000000000000000000000000000000000000000000000000000000000000000000070000000000000700000000000000000000000000000000000000000000wTTTTETTTTTTTTTTTTT2
0000000000000000000000000000000000000000000000000000000000000000000000000000000000000700000000700000000000000000000000000000000000000000000000000000000000000000000007000000000000070000000000000000000000000000000000000000000021111111111111111112
00000000000000000000000000000000000000000000000000000000000000000000000000000000000007000000007000000000000000000000000000000000000000000000000000000000000000000000070000000000000700000000000000000000000000000000000000000000w0000000000000000002
00000000000000000000000000000000000000000000000000000000000000000000000000000000000007000000007000000000000000000000000000000000000000000000000000000000000000000000070000000000000700000000000000000000000000000000000000000000wTETTTTTTTTTTTTTTTT2
0000000000000000000000000000000000000000000000000000000000000000000000000000000000000700000000700000000000000000000000000000000000000000000000000000000000000000000007000000000000070000000000000000000000000000000000000000000021111111111111111112
0000000000000000000000000000000000000000000000000000000000000000000000000000000000000700000000700000000000s000000000000000000000000000000000000000000000000000000000070000000000000700000000000000000000000000000000000000000000w0000000000000000002
00000000000000000000000000000000000000000000000000000000000000000000000000000000000007000000007000000000011111111111111100000000000000000000000000000000000000000000070000000000000700000000000000000000000000000000000000000000wTTTTTTTTTTTTTTTTET2
000000000000000000000000000000000000000000000000000000000000000000000000000000000000070000000070000000000d0000000000000d0000000000000000000000000000000000000000000007000000000000070000000000000000000000000000000000000000000021111111111111111112
000000000000000000000000000000000000000000000000000000000000000000000000000000000000070000000070000000000d0000000000000d00000000000000000000000000000000000000000000070000000000000700000000000000000000000000000000000000000000w0000000000000000002
00000000000000000000000000000000000000000000000000000000000000000000000000000000000001111111111000000000021111111111111100000000000000000000000000000000000000000000070000000000000700000000000000000000000000000000000000000000wTTTTTETTTTTTTTTTTT2
0000000000000000000000000000000000000000000000000000000000000000000000000000000000000d00000000d0000000000d0000000000000d0000000000000000000000000000000000000000000001111111111111110000000000000000000000000000000000000000000021111111111111111111
0000000000000000000000000000000000000000000000000000000000000000000000000000000000000d00000000d0000000000d0000000000000d000000000000000000000000000000000000000000000d0000000000000d0000000000000000000000000000000000000000000022222222222222222222
000000000000000000000000000000000000000000000000000000000000000000000000000000000000011111111110000000000111111111111111000000000000000000000000000000000000000000000d0000000000000d0000000000000000000000000000000000000000000022222222222222222222
000000000000000000000000000000000000000000000000000000000000000000000000000000000000000000000000000000000d0000000000000d0000000000000000000000000000000000000000000001111111111111110000000000000000000000000000000000000000000022222222222222222222
000000P00000000000000000000000000000000000000000000000000000000000000000000000000s00000000000000000000000d000000000TTETdTTTTT0000000000000000000000000000000000000000000000000000000000000000000000000000000000000000TTTTTETT00022222222222222222222
1111111111111110000000000111111111100000000000000000000111111111100000000001111111111000000000011111111111111111111111111111100000000001111111111111111111100000000000000000000000000000000001111111111000000000011111111111111112222222222222222222
2222222222222220000000000222222222200000000000000000000222222222200000000002222222222000000000022222222222222222222222222222200000000002222222222222222222200000000000000000000000000000000002222222222000000000022222222222222222222222222222222222
2222222222222220000000000222222222200000000000000000000222222222200000000002222222222000000000022222222222222222222222222222200000000002222222222222222222200000000000000000000000000000000002222222222000000000022222222222222222222222222222222222
2222222222222220000000000222222222200000000000000000000222222222200000000002222222222000000000022222222222222222222222222222200000000002222222222222222222200000000001111111111111110000000002222222222000000000022222222222222222222222222222222222
2222222222222220000000000222222222200000000000000000000222222222200000000002222222222000000000022222222222222222222222222222200000000002222222222222222222200000000002222222222222220000000002222222222000000000022222222222222222222222222222222222