                                                                                                                                                                                                                                                    
                                                                                                                                                                                                                                        1           
                                                                                                                                                                                                                                        11          
                                                                                                                                                                                                                                11111111111111111111
                                                                                                                                                                                                                                1                   
                                                                                                                                                                                                                                1TTTETTTTTTTTTTTTTTT 
                                                                                                                                                                                                                                11111111111111111111
                                                                                                                                                                                                                                1                   
                                                                                                                                                                                                                                1TTTTTTTTETTTTTTTTTT 
                                                                                                                                                                                                                                11111111111111111111
                                                                                                                                                                                                                                1                   
                                                                                                                                                                                                                                1TTTTTTTTTTTETTTTTTT
                                                                                                                                                                                                                                11111111111111111111
                                                                                                                                                                                                                                1                   
                                                                                                                                                                                                                                1TTTTTTTTETTTTTTTTTT
                                                                                                                                                                                                                                11111111111111111111
                                                                                                                                                                                                                                1                   
                                                                                                                                                                                                                                1TTTTETTTTTTTTTTTTTT
                                                                                                                                                                                                                                11111111111111111111
                                                                                                                                                                                                                                1                   
                                                                                                                                                                                                                                1TETTTTTTTTTTTTTTTTT
                                                                                                                                                                                                                                11111111111111111111
                                                                                                                                                                                                                                1                   
                                                                                                         111111111111111                                                                                                        1TTTTTTTTTTTTTTTTETT 
                                                                                                         1             1                                                                                                        11111111111111111111
                                                                                                         1             1                                                                                                        1                   
                                                                                                         111111111111111                                                                                                        1TTTTTETTTTTTTTTTTTT 
                                                                                                         1             1                                             111111111111111                                            11111111111111111111
                                                                                                         1             1                                             1             1                                            11111111111111111111
                                                                                                         111111111111111                                             1             1                                            11111111111111111111
                                                                                                         1             1                                             111111111111111                                            11111111111111111111
                                                                                                         1         TTET1TTTTT                                                                                        TTTTTETT   11111111111111111111
111111111111111          1111111111                    1111111111          1111111111          111111111111111111111111111111          11111111111111111111                                  1111111111          11111111111111111111111111111111111
111111111111111          1111111111                    1111111111          1111111111          111111111111111111111111111111          11111111111111111111                                  1111111111          11111111111111111111111111111111111
111111111111111          1111111111                    1111111111          1111111111          111111111111111111111111111111          11111111111111111111                                  1111111111          11111111111111111111111111111111111
111111111111111          1111111111                    1111111111          1111111111          111111111111111111111111111111          11111111111111111111          111111111111111         1111111111          11111111111111111111111111111111111
111111111111111          1111111111                    1111111111          1111111111          111111111111111111111111111111          11111111111111111111          111111111111111         1111111111          11111111111111111111111111111111111