0000000000000000000000000000000000000000000000000000000000000000000000000000000000000b00000000b0000000000000000000000000000000000000000000000000000000000000000000000b0000000000000b0000000000000000000000000000000000000000000000000000000000000000
0000000000000000000000000000000000000000000000000000000000000000000000000000000000000b00000000b0000000000000000000000000000000000000000000000000000000000000000000000b0000000000000b0000000000000000000000000000000000000000000000000000000000000000
0000000000000000000000000000000000000000000000000000000000000000000000000000000000000b00000000b0000000000000000000000000000000000000000000000000000000000000000000000b0000000000000b0000000000000000000000000000000000000000000000000000000000000000
0000000000000000000000000000000000000000000000000000000000000000000000000000000000000b00000000b0000000000000000000000000000000000000000000000000000000000000000000000b0000000000000b0000000000000000000000000000000000000000000000000000000000000000
0000000000000000000000000000000000000000000000000000000000000000000000000000000000000b00000000b0000000000000000000000000000000000000000000000000000000000000000000000b0000000000000b0000000000000000000000000000000000000000000000000000000000000000
0000000000000000000000000000000000000000000000000000000000000000000000000000000000000b00000000b0000000000000000000000000000000000000000000000000000000000000000000000b0000000000000b0000000000000000000000000000000000000000000000000000000000000000
0000000000000000000000000000000000000000000000000000000000000000000000000000000000000b00000000b0000000000000000000000000000000000000000000000000000000000000000000000b0000000000000b0000000000000000000000000000000000000000000000000000000000000000
0000000000000000000000000000000000000000000000000000000000000000000000000000000000000b00000000b0000000000000000000000000000000000000000000000000000000000000000000000b0000000000000b0000000000000000000000000000000000000000000000000000000000000000
0000000000000000000000000000000000000000000000000000000000000000000000000000000000000b00000000b0000000000000000000000000000000000000000000000000000000000000000000000b0000000000000b0000000000000000000000000000000000000000000000000000000000000000
0000000000000000000000000000000000000000000000000000000000000000000000000000000000000b00000000b0000000000000000000000000000000000000000000000000000000000000000000000b0000000000000b000000000000000000000000000000000000000000000li00000000000000000
0000000000000000000000000000000000000000000000000000000000000000000000000000000000000b00000000b0000000000000000000000000000000000000000000000000000000000000000000000b0000000000000b00000000000000000000000000000000000000000000l0i00000000000000000
0000000000000000000000000000000000000000000000000000000000000000000000000000000000000b00000000b0000000000000000000000000000000000000000000000000000000000000000000000b0000000000000b000000000000000000000000000000000oiiiiiiiiiiiiiiiiiirr0000000000
0000000000000000000000000000000000000000000000000000000000000000000000000000000000000b00000000b0000000000000000000000000000000000000000000000000000000000000000000000b0000000000000b000000000000000000000000000000000000b0000b0000i0000Qrr0000000000
0000000000000000000000000000000000000000000000000000000000000000000000000000000000000b00000000b0000000000000000000000000000000000000000000000000000000000000000000000b0000000000000b000000000000000000000000000000000000b0000b0000i0000Q000000000000
0000000000000000000000000000000000000000000000000000000000000000000000000000000000000b00000000b0000000000000000000000000000000000000000000000000000000000000000000000b0000000000000b000000000000000000000000000000000000b0000b0000i0000Q000000000000
0000000000000000000000000000000000000000000000000000000000000000000000000000000000000b00000000b0000000000000000000000000000000000000000000000000000000000000000000000b0000000000000b000000000000000000000000000000000000b0000b0000i0000Q900000000000
0000000000000000000000000000000000000000000000000000000000000000000000000000000000000b00000000b0000000000000000000000000000000000000000000000000000000000000000000000b0000000000000b000000000000000000000000000000000000b0000b0051111111111111111116
0000000000000000000000000000000000000000000000000000000000000000000000000000000000000b00000000b0000000000000000000000000000000000000000000000000000000000000000000000b0000000000000b000000000000000000000000000000000000uu000b0080000000000000000002
0000000000000000000000000000000000000000000000000000000000000000000000000000000000000b00000000b0000000000000000000000000000000000000000000000000000000000000000000000b0000000000000b000000000000000000000000000000000000b0000b008TTTETTTTTTTTTTTTTT2
0000000000000000000000000000000000000000000000000000000000000000000000000000000000000b00000000b0000000000000000000000000000000000000000000000000000000000000000000000b0000000000000b000000000000000000000000000000000000b0000b0011111111111111111112
0000000000000000000000000000000000000000000000000000000000000000000000000000000000000b00000000b0000000000000000000000000000000000000000000000000000000000000000000000b0000000000000b000000000000000000000000000000000000b000uu0080000000000000000002
0000000000000000000000000000000000000000000000000000000000000000000000000000000000000b00000000b0000000000000000000000000000000000000000000000000000000000000000000000b0000000000000b000000000000000000000000000000000000b0000b008TTTTTTTTETTTTTTTTT2
0000000000000000000000000000000000000000000000000000000000000000000000000000000000000b00000000b0000000000000000000000000000000000000000000000000000000000000000000000b0000000000000b000000000000000000000000000000000000b0000b0011111111111111111112
0000000000000000000000000000000000000000000000000000000000000000000000000000000000000b00000000b0000000000000000000000000000000000000000000000000000000000000000000000b0000000000000b000000000000000000000000000000000000b0000b0080000000000000000002
0000000000000000000000000000000000000000000000000000000000000000000000000000000000000b00000000b0000000000000000000000000000000000000000000000000000000000000000000000b0000000000000b000000000000000000000000000000000000uu000b008TTTTTTTTTTTETTTTTT2
0000000000000000000000000000000000000000000000000000000000000000000000000000000000000b00000000b0000000000000000000000000000000000000000000000000000000000000000000000b0000000000000b000000000000000000000000000000000000b0000b0011111111111111111112
0000000000000000000000000000000000000000000000000000000000000000000000000000000000000b00000000b0000000000000000000000000000000000000000000000000000000000000000000000b0000000000000b000000000000000000000000000000000000b0000b0080000000000000000002
0000000000000000000000000000000000000000000000000000000000000000000000000000000000000b00000000b0000000000000000000000000000000000000000000000000000000000000000000000b0000000000000b000000000000000000000000000000000000b000uu008TTTTTTTTETTTTTTTTT2
0000000000000000000000000000000000000000000000000000000000000000000000000000000000000b00000000b0000000000000000000000000000000000000000000000000000000000000000000000b0000000000000b000000000000000000000000000000000000b0000b0011111111111111111112
0000000000000000000000000000000000000000000000000000000000000000000000000000000000000b00000000b0000000000000000000000000000000000000000000000000000000000000000000000b0000000000000b000000000000000000000000000000000000b0000b0080000000000000000002
0000000000000000000000000000000000000000000000000000000000000000000000000000000000000b00000000b0000000000000000000000000000000000000000000000000000000000000000000000b0000000000000b000000000000000000000000000000000000uu000b008TTTTETTTTTTTTTTTTT2
0000000000000000000000000000000000000000000000000000000000000000000000000000000000000b00000000b0000000000000000000000000000000000000000000000000000000000000000000000b0000000000000b000000000000000000000000000000000000b0000b0011111111111111111112
0000000000000000000000000000000000000000000000000000000000000000000000000000000000000b00000000b0000000000000000000000000000000000000000000000000000000000000000000000b0000000000000b000000000000000000000000000000000000b000uu0080000000000000000002
0000000000000000000000000000000000000000000000000000000000000000000000000000000000000b00000000b000000000000000000000k000000000000000000000000000000000000000000000000b0000000000000b000000000000000000000000000000000000b0000b008TETTTTTTTTTTTTTTTT2
0000000000000000000000000000000000000000000000000000000000000000000000000000000000000b00000000b000000000000000000jkkj000000000000000000000000000000000000000000000000b0000000000000b000000000000000000000000000000000000uu000b0011111111111111111112
0000000000000000000000000000000000000000000000000000000000000000000000000000000000000b00000000b000000000000000FGGjjjjGGH000000000000000000000000000000000000000000000b0000000000000b000000000000000000000000000000000000b0000b0080000000000000000002
0000000000000000000000000000000000000000000000000000000000000000000000000000000000000b00000000b0000000000511111111111116000000000000000000000000000000000000000000000b0000000000000b000000000000000000000000000000000000b000uu008TTTTTTTTTTTTTTTTET2
0000000000000000000000000000000000000000000000000000000000000000000000000000000000000b00000000b0000000000000000000000000000000000000000000000000000000000000000000000b0000000000000b000000000000000000000000000000000000b0000b0011111111111111111112
0000n00000000000000000000000000000000000000000000000000000000000000000000000000000000b00000000b0000000000900000000000009000000000000000000000000000000000000000000000b000000000k000b000000000000000000000000000000000000uu000b0080000000000000000002
000000000000000000000000000000000000000000000000000000000000000000000000000000000000051111111160000000000511111111111116000000000000000000000000000000000000000000000b00000000kk000b00000000000000000000000000000000000000000b008TTTTTETTTTTTTTTTTT2
0000000000000000000000000000000000000000000000000000000000000000000000000000000000000000000000000000000000000000000000000000000000000000000000000000000000000000000005111111111111160000000000000000000000000000000000000000uu0011111111111111111112
000000000000000000000000000000000000000000000000000000000000000000000000000000000000090000000090000000000d0000000000000D0000000000000000000000000000000000000000000000000000000000000000000000000000000000000000000000000000000037777777777777777772
00000000000000000000000000000000000000000000000000000000000000000000000000000uu0000005111111116000000000051111111111111600000000000000000000000000000uuu0000000000000d0000000000000D0000000000000000000000000000000000000000000037777777777777777772
00P0000000000000000000000000000jk000000000000000000000000k0000000000000000000uu0000000n000000000000uu00000000000000000000000000000000000000000000j000uuu0000000000000511111111111116000000000000000k000000000000000000000000000037777777777777777772
000000Q0kj00a000000000000FGGGGGjkH00000000000000000000000jj000000000000000000uu00000000000000000FGGuuGGH0D0a0s00000TTETDTTT0000000000000000FGGGGkjH00uuu0s000000000000000000000000000000000000uu000k00000000000000000TTTTTETT00037777777777777777772
511111111111116f00000000m511111111600000000000000000000511111111600000000005111111116000000000051111111111111111111111111111600000000005111111111111111111600000000000000000000000000000000005111111116000000000051111111111111177777777777777777772
3777777777777720000000000377777777200000000000000000000377777777200000000003777777772000000000037777777777777777777777777777200000000003777777777777777777200000000000000a0FGGGGGGH00000000003777777772000000000037777777777777777777777777777777772
3777777777777720000000000377777777200000000000000000000377777777200000000003777777772000000000037777777777777777777777777777200000000003777777777777777777200000000005111111111111160000000003777777772000000000037777777777777777777777777777777772
3777777777777720000000000377777777200000000000000000000377777777200000000003777777772000000000037777777777777777777777777777200000000003777777777777777777200000000003777777777777720000000003777777772000000000037777777777777777777777777777777772
3777777777777720000000000377777777200000000000000000000377777777200000000003777777772000000000c37777777777777777777777777777200000000003777777777777777777200000000003777777777777720000000003777777772000000000037777777777777777777777777777777772
3777777777777720000000000377777777200000000000000000000377777777200000000003777777772000000000037777777777777777777777777777200000000003777777777777777777200000000003777777777777720000000003777777772000000000037777777777777777777777777777777772
3777777777777720000000000377777777200000000000000000000377777777200000000003777777772000000000037777777777777777777777777777200000000003777777777777777777200000000003777777777777720000000003777777772000000000037777777777777777777777777777777772
3777777777777720000000000377777777200000000000000000000377777777200000000003777777772000000000037777777777777777777777777777200000000003777777777777777777200000000003777777777777720000000003777777772000000000037777777777777777777777777777777772
3777777777777720000000000377777777200000000000000000000377777777200000000003777777772000000000037777777777777777777777777777200000000003777777777777777777200000000003777777777777720000000003777777772000000000037777777777777777777777777777777772
3777777777777720000000000377777777200000000000000000000377777777200000000003777777772000000000037777777777777777777777777777200000000003777777777777777777200000000003777777777777720000000003777777772000000000037777777777777777777777777777777772
3777777777777720000000000377777777200000000000000000000377777777200000000003777777772000000000037777777777777777777777777777200000000003777777777777777777200000000003777777777777720000000003777777772000000000037777777777777777777777777777777772
3777777777777720000000000377777777200000000000000000000377777777200000000003777777772000000000037777777777777777777777777777200000000003777777777777777777200000000003777777777777720000000003777777772000000000037777777777777777777777777777777772
3777777777777720000000000377777777200000000000000000000377777777200000000003777777772000000000037777777777777777777777777777200000000003777777777777777777200000000003777777777777720000000003777777772000000000037777777777777777777777777777777772
3777777777777720000000000377777777200000000000000000000377777777200000000003777777772000000000037777777777777777777777777777200000000003777777777777777777200000000003777777777777720000000003777777772000000000037777777777777777777777777777777772
3777777777777720000000000377777777200000000000000000000377777777200000000003777777772000000000037777777777777777777777777777200000000003777777777777777777200000000003777777777777720000000003777777772000000000037777777777777777777777777777777772
3777777777777720000000000377777777200000000000000000000377777777200000000003777777772000000000037777777777777777777777777777200000000003777777777777777777200000000003777777777777720000000003777777772000000000037777777777777777777777777777777772
3777777777777720000000000377777777200000000000000000000377777777200000000003777777772000000000037777777777777777777777777777200000000003777777777777777777200000000003777777777777720000000003777777772000000000037777777777777777777777777777777772
3777777777777720000000000377777777200000000000000000000377777777200000000003777777772000000000037777777777777777777777777777200000000003777777777777777777200000000003777777777777720000000003777777772000000000037777777777777777777777777777777772
3777777777777720000000000377777777200000000000000000000377777777200000000003777777772000000000037777777777777777777777777777200000000003777777777777777777200000000003777777777777720000000003777777772000000000037777777777777777777777777777777772
3777777777777720000000000377777777200000000000000000000377777777200000000003777777772000000000037777777777777777777777777777200000000003777777777777777777200000000003777777777777720000000003777777772000000000037777777777777777777777777777777772
3777777777777720000000000377777777200000000000000000000377777777200000000003777777772000000000037777777777777777777777777777200000000003777777777777777777200000000003777777777777720000000003777777772000000000037777777777777777777777777777777772
3777777777777720000000000377777777200000000000000000000377777777200000000003777777772000000000037777777777777777777777777777200000000003777777777777777777200000000003777777777777720000000003777777772000000000037777777777777777777777777777777772
3777777777777720000000000377777777200000000000000000000377777777200000000003777777772000000000037777777777777777777777777777200000000003777777777777777777200000000003777777777777720000000003777777772000000000037777777777777777777777777777777772
3777777777777720000000000377777777200000000000000000000377777777200000000003777777772000000000037777777777777777777777777777200000000003777777777777777777200000000003777777777777720000000003777777772000000000037777777777777777777777777777777772