000000000000000000000000000000000000000000000000000000000000000000000000000000000000000000000000000
000000000000000000000000000000000000000000000000000000000000000000000000000000000000000000000000000
000000000000000000000000000000000000000000000000000000000000000000000000000000000000000000000000000
000000000000000000000000000000000000000000000000000000000000000000000000000000000000000000000000000
000000000000000000000000000000000000000000000000000000000000000000000000000000000000000000000000000
111111111111111111111111111111000000000000000000000000000000000000000111111111111111111111111111111
122222222222222222222222222221000000000000000000000000000000000000000122222222222222222222222222221
122222222222222222222222222221000000000000000000000000000000000000000122222222222222222222222222221
122222222222222222222222222220000000000000000000000000000000000000000022222222222222222222222222221
122222222222222222222222222220000000000000000000000000000000000000000022222222222222222222222222221
122222222222222222222222222220000000000000000000000000000000000000000022222222222222222222222222221
111111111111111111111111111111000000000000000000000000000000000000000111111111111111111111111111111
111111111111111111111111111111000000000000000000000000000000000000000111111111111111111111111111111
122222222222222222222222222221000000000000000000000000000000000000000122222222222222222222222222221
122222222222222222222222222221000000000000000000000000000000000000000122222222222222222222222222221
122222222222222222222222222221000000000000000000000000000000000000000122222222222222222222222222221
122222222222222222222222222220000000000000000000000000000000000000000022222222222222222222222222221
122222222222222222222222222220000000000000000000000000000000000000000022222222222222222222222222221
122222222222222222222222222220000000000000000000000000000000000000000022222222222222222222222222221
111111111111111111111111111111111111111111111111111111111111111111111111111111111111111111111111111
111111111111111111111111111111111111111111111111111111111111111111111111111111111111111111111111111
111111111111111111111111111111111111111111111111111111111111111111111111111111111111111111111111111
111111111111111111111111111111111111111111111111111111111111111111111111111111111111111111111111111
111111111111111111111111111111111111111111111111111111111111111111111111111111111111111111111111111
111111111111111111111111111111111111111111111111111111111111111111111111111111111111111111111111111
111111111111111111111111111111111111111111111111111111111111111111111111111111111111111111111111111
111111111111111111111111111111111111111111111111111111111111111111111111111111111111111111111111111
111111111111111111111111111111111111111111111111111111111111111111111111111111111111111111111111111
111111111111111111111111111111111111111111111111111111111111111111111111111111111111111111111111111