0000000000000000000000000000000000000000000000000000000000000000000000000000000000000b00000000b0000000000000000000000000000000000000000000000000000000000000000000000b0000000000000b0000000000000000000000000000000000000000000000000000000000000000
0000000000000000000000000000000000000000000000000000000000000000000000000000000000000b00000000b0000000000000000000000000000000000000000000000000000000000000000000000b0000000000000b0000000000000000000000000000000000000000000000000000000000000000
0000000000000000000000000000000000000000000000000000000000000000000000000000000000000b00000000b0000000000000000000000000000000000000000000000000000000000000000000000b0000000000000b0000000000000000000000000000000000000000000000000000000000000000
0000000000000000000000000000000000000000000000000000000000000000000000000000000000000b00000000b0000000000000000000000000000000000000000000000000000000000000000000000b0000000000000b0000000000000000000000000000000000000000000000000000000000000000
0000000000000000000000000000000000000000000000000000000000000000000000000000000000000b00000000b0000000000000000000000000000000000000000000000000000000000000000000000b0000000000000b0000000000000000000000000000000000000000000000000000000000000000
0000000000000000000000000000000000000000000000000000000000000000000000000000000000000b00000000b0000000000000000000000000000000000000000000000000000000000000000000000b0000000000000b0000000000000000000000000000000000000000000000000000000000000000
0000000000000000000000000000000000000000000000000000000000000000000000000000000000000b00000000b0000000000000000000000000000000000000000000000000000000000000000000000b0000000000000b0000000000000000000000000000000000000000000000000000000000000000
0000000000000000000000000000000000000000000000000000000000000000000000000000000000000b00000000b0000000000000000000000000000000000000000000000000000000000000000000000b0000000000000b0000000000000000000000000000000000000000000000000000000000000000
0000000000000000000000000000000000000000000000000000000000000000000000000000000000000b00000000b0000000000000000000000000000000000000000000000000000000000000000000000b0000000000000b0000000000000000000000000000000000000000000000000000000000000000
0000000000000000000000000000000000000000000000000000000000000000000000000000000000000b00000000b0000000000000000000000000000000000000000000000000000000000000000000000b0000000000000b0000000000000000000000000000000000000000000000000000000000000000
0000000000000000000000000000000000000000000000000000000000000000000000000000000000000b00000000b0000000000000000000000000000000000000000000000000000000000000000000000b0000000000000b0000000000000000000000000000000000000000000000000000000000000000
0000000000000000000000000000000000000000000000000000000000000000000000000000000000000b00000000b0000000000000000000000000000000000000000000000000000000000000000000000b0000000000000b0000000000000000000000000000000000000000000000000000000000000000
0000000000000000000000000000000000000000000000000000000000000000000000000000000000000b00000000b0000000000000000000000000000000000000000000000000000000000000000000000b0000000000000b0000000000000000000000000000000000000000000000000000000000000000
0000000000000000000000000000000000000000000000000000000000000000000000000000000000000b00000000b0000000000000000000000000000000000000000000000000000000000000000000000b0000000000000b0000000000000000000000000000000000000000000000000000000000000000
0000000000000000000000000000000000000000000000000000000000000000000000000000000000000b00000000b0000000000000000000000000000000000000000000000000000000000000000000000b0000000000000b0000000000000000000000000000000000000000000000000000000000000000
0000000000000000000000000000000000000000000000000000000000000000000000000000000000000b00000000b0000000000000000000000000000000000000000000000000000000000000000000000b0000000000000b0000000000000000000000000000000000000000000000000000910000000000
0000000000000000000000000000000000000000000000000000000000000000000000000000000000000b00000000b0000000000000000000000000000000000000000000000000000000000000000000000b0000000000000b0000000000000000000000000000000000000000000051111111111111111116
0000000000000000000000000000000000000000000000000000000000000000000000000000000000000b00000000b0000000000000000000000000000000000000000000000000000000000000000000000b0000000000000b0000000000000000000000000000000000000000000080000000000000000002
0000000000000000000000000000000000000000000000000000000000000000000000000000000000000b00000000b0000000000000000000000000000000000000000000000000000000000000000000000b0000000000000b000000000000000000000000000000000000000000008TTTETTTTTTTTTTTTTT2
0000000000000000000000000000000000000000000000000000000000000000000000000000000000000b00000000b0000000000000000000000000000000000000000000000000000000000000000000000b0000000000000b0000000000000000000000000000000000000000000011111111111111111112
0000000000000000000000000000000000000000000000000000000000000000000000000000000000000b00000000b0000000000000000000000000000000000000000000000000000000000000000000000b0000000000000b0000000000000000000000000000000000000000000080000000000000000002
0000000000000000000000000000000000000000000000000000000000000000000000000000000000000b00000000b0000000000000000000000000000000000000000000000000000000000000000000000b0000000000000b000000000000000000000000000000000000000000008TTTTTTTTETTTTTTTTT2
0000000000000000000000000000000000000000000000000000000000000000000000000000000000000b00000000b0000000000000000000000000000000000000000000000000000000000000000000000b0000000000000b0000000000000000000000000000000000000000000011111111111111111112
0000000000000000000000000000000000000000000000000000000000000000000000000000000000000b00000000b0000000000000000000000000000000000000000000000000000000000000000000000b0000000000000b0000000000000000000000000000000000000000000080000000000000000002
0000000000000000000000000000000000000000000000000000000000000000000000000000000000000b00000000b0000000000000000000000000000000000000000000000000000000000000000000000b0000000000000b000000000000000000000000000000000000000000008TTTTTTTTTTTETTTTTT2
0000000000000000000000000000000000000000000000000000000000000000000000000000000000000b00000000b0000000000000000000000000000000000000000000000000000000000000000000000b0000000000000b0000000000000000000000000000000000000000000011111111111111111112
0000000000000000000000000000000000000000000000000000000000000000000000000000000000000b00000000b0000000000000000000000000000000000000000000000000000000000000000000000b0000000000000b0000000000000000000000000000000000000000000080000000000000000002
0000000000000000000000000000000000000000000000000000000000000000000000000000000000000b00000000b0000000000000000000000000000000000000000000000000000000000000000000000b0000000000000b000000000000000000000000000000000000000000008TTTTTTTTETTTTTTTTT2
0000000000000000000000000000000000000000000000000000000000000000000000000000000000000b00000000b0000000000000000000000000000000000000000000000000000000000000000000000b0000000000000b0000000000000000000000000000000000000000000011111111111111111112
0000000000000000000000000000000000000000000000000000000000000000000000000000000000000b00000000b0000000000000000000000000000000000000000000000000000000000000000000000b0000000000000b0000000000000000000000000000000000000000000080000000000000000002
0000000000000000000000000000000000000000000000000000000000000000000000000000000000000b00000000b0000000000000000000000000000000000000000000000000000000000000000000000b0000000000000b000000000000000000000000000000000000000000008TTTTETTTTTTTTTTTTT2
0000000000000000000000000000000000000000000000000000000000000000000000000000000000000b00000000b0000000000000000000000000000000000000000000000000000000000000000000000b0000000000000b0000000000000000000000000000000000000000000011111111111111111112
0000000000000000000000000000000000000000000000000000000000000000000000000000000000000b00000000b0000000000000000000000000000000000000000000000000000000000000000000000b0000000000000b0000000000000000000000000000000000000000000080000000000000000002
0000000000000000000000000000000000000000000000000000000000000000000000000000000000000b00000000b0000000000000000000000000000000000000000000000000000000000000000000000b0000000000000b000000000000000000000000000000000000000000008TETTTTTTTTTTTTTTTT2
0000000000000000000000000000000000000000000000000000000000000000000000000000000000000b00000000b0000000000000000000000000000000000000000000000000000000000000000000000b0000000000000b0000000000000000000000000000000000000000000011111111111111111112
0000000000000000000000000000000000000000000000000000000000000000000000000000000000000b00000000b00000000000s0000000000000000000000000000000000000000000000000000000000b0000000000000b0000000000000000000000000000000000000000000080000000000000000002
0000000000000000000000000000000000000000000000000000000000000000000000000000000000000b00000000b0000000000511111111111116000000000000000000000000000000000000000000000b0000000000000b000000000000000000000000000000000000000000008TTTTTTTTTTTTTTTTET2
0000000000000000000000000000000000000000000000000000000000000000000000000000000000000b00000000b0000000000900000000000009000000000000000000000000000000000000000000000b0000000000000b0000000000000000000000000000000000000000000011111111111111111112
0000000000000000000000000000000000000000000000000000000000000000000000000000000000000b00000000b0000000000900000000000009000000000000000000000000000000000000000000000b000000000k000b0000000000000000000000000000000000000000000080000000000000000002
000000000000000000000000000000000000000000000000000000000000000000000000000000000000051111111160000000000511111111111116000000000000000000000000000000000000000000000b00000000kk000b000000000000000000000000000000000000000000008TTTTTETTTTTTTTTTTT2
00000000000000000000000000000000000000000000000000000000000000000000000000000000000009000000009000000P0009000000000000090000000000000000000000000000000000000000000005111111111111160000000000000000000000000000000000000000000011111111111111111112
0000000000000000000000000000000000000000000000000000000000000000000000000000000000000900000000900000000009000000000000090000000000000000000000000000000000000000000009000000000000090000000000000000000000000000000000000000000037777777777777777772
0000000000000000000000000000000000000000000000000000000000000000000000000000000000000511111111600000000005111111111111160000000000000000000000000000000000000000000009000000000000090000000000000000000000000000000000000000000037777777777777777772
0000000000000000000000000000000jk000000000000000000000000k000000000000000000000000000000000000000000000009000000000000090000000000000000000000000j0000000000000000000511111111111116000000000000000k000000000000000000000000000037777777777777777772
00000000kj000000000000000000000jk000000000000000000000000jj0000000000000000000000s000000000000000000000009000000000TTET9TTT000000000000000000000kj0000000000000000000000000000000000000000000000000k00000000000000000TTTTTETT00037777777777777777772
5111111111111160000000000511111111600000000000000000000511111111600000000005111111116000000000051111111111111111111111111111600000000005111111111111111111600000000000000000000000000000000005111111116000000000051111111111111177777777777777777772
377777777777772000000000037777777720000000000000000000037777777720000000000377777777200000000003777777777777777777777777777720000000000377777777777777777720000000000000j000000000000000000003777777772000000000037777777777777777777777777777777772
3777777777777720000000000377777777200000000000000000000377777777200000000003777777772000000000037777777777777777777777777777200000000003777777777777777777200000000005111111111111160000000003777777772000000000037777777777777777777777777777777772
3777777777777720000000000377777777200000000000000000000377777777200000000003777777772000000000037777777777777777777777777777200000000003777777777777777777200000000003777777777777720000000003777777772000000000037777777777777777777777777777777772
3777777777777720000000000377777777200000000000000000000377777777200000000003777777772000000000037777777777777777777777777777200000000003777777777777777777200000000003777777777777720000000003777777772000000000037777777777777777777777777777777772
3777777777777720000000000377777777200000000000000000000377777777200000000003777777772000000000037777777777777777777777777777200000000003777777777777777777200000000003777777777777720000000003777777772000000000037777777777777777777777777777777772
3777777777777720000000000377777777200000000000000000000377777777200000000003777777772000000000037777777777777777777777777777200000000003777777777777777777200000000003777777777777720000000003777777772000000000037777777777777777777777777777777772
3777777777777720000000000377777777200000000000000000000377777777200000000003777777772000000000037777777777777777777777777777200000000003777777777777777777200000000003777777777777720000000003777777772000000000037777777777777777777777777777777772
3777777777777720000000000377777777200000000000000000000377777777200000000003777777772000000000037777777777777777777777777777200000000003777777777777777777200000000003777777777777720000000003777777772000000000037777777777777777777777777777777772
3777777777777720000000000377777777200000000000000000000377777777200000000003777777772000000000037777777777777777777777777777200000000003777777777777777777200000000003777777777777720000000003777777772000000000037777777777777777777777777777777772
3777777777777720000000000377777777200000000000000000000377777777200000000003777777772000000000037777777777777777777777777777200000000003777777777777777777200000000003777777777777720000000003777777772000000000037777777777777777777777777777777772
3777777777777720000000000377777777200000000000000000000377777777200000000003777777772000000000037777777777777777777777777777200000000003777777777777777777200000000003777777777777720000000003777777772000000000037777777777777777777777777777777772
3777777777777720000000000377777777200000000000000000000377777777200000000003777777772000000000037777777777777777777777777777200000000003777777777777777777200000000003777777777777720000000003777777772000000000037777777777777777777777777777777772
3777777777777720000000000377777777200000000000000000000377777777200000000003777777772000000000037777777777777777777777777777200000000003777777777777777777200000000003777777777777720000000003777777772000000000037777777777777777777777777777777772
3777777777777720000000000377777777200000000000000000000377777777200000000003777777772000000000037777777777777777777777777777200000000003777777777777777777200000000003777777777777720000000003777777772000000000037777777777777777777777777777777772
3777777777777720000000000377777777200000000000000000000377777777200000000003777777772000000000037777777777777777777777777777200000000003777777777777777777200000000003777777777777720000000003777777772000000000037777777777777777777777777777777772
3777777777777720000000000377777777200000000000000000000377777777200000000003777777772000000000037777777777777777777777777777200000000003777777777777777777200000000003777777777777720000000003777777772000000000037777777777777777777777777777777772
3777777777777720000000000377777777200000000000000000000377777777200000000003777777772000000000037777777777777777777777777777200000000003777777777777777777200000000003777777777777720000000003777777772000000000037777777777777777777777777777777772
3777777777777720000000000377777777200000000000000000000377777777200000000003777777772000000000037777777777777777777777777777200000000003777777777777777777200000000003777777777777720000000003777777772000000000037777777777777777777777777777777772
3777777777777720000000000377777777200000000000000000000377777777200000000003777777772000000000037777777777777777777777777777200000000003777777777777777777200000000003777777777777720000000003777777772000000000037777777777777777777777777777777772
3777777777777720000000000377777777200000000000000000000377777777200000000003777777772000000000037777777777777777777777777777200000000003777777777777777777200000000003777777777777720000000003777777772000000000037777777777777777777777777777777772
3777777777777720000000000377777777200000000000000000000377777777200000000003777777772000000000037777777777777777777777777777200000000003777777777777777777200000000003777777777777720000000003777777772000000000037777777777777777777777777777777772
3777777777777720000000000377777777200000000000000000000377777777200000000003777777772000000000037777777777777777777777777777200000000003777777777777777777200000000003777777777777720000000003777777772000000000037777777777777777777777777777777772
3777777777777720000000000377777777200000000000000000000377777777200000000003777777772000000000037777777777777777777777777777200000000003777777777777777777200000000003777777777777720000000003777777772000000000037777777777777777777777777777777772