0000000000000000000000000000000000000000000000000000000000000000000000000000000000000b00000000b0000000000000000000000000000000000000000000000000000000000000000000000b0000000000000b0000000000000000000000000000000000000000000000000000000000000000
0000000000000000000000000000000000000000000000000000000000000000000000000000000000000b00000000b0000000000000000000000000000000000000000000000000000000000000000000000b0000000000000b0000000000000000000000000000000000000000000000000000000000000000
0000000000000000000000000000000000000000000000000000000000000000000000000000000000000b00000000b0000000000000000000000000000000000000000000000000000000000000000000000b0000000000000b0000000000000000000000000000000000000000000000000000000000000000
0000000000000000000000000000000000000000000000000000000000000000000000000000000000000b00000000b0000000000000000000000000000000000000000000000000000000000000000000000b0000000000000b0000000000000000000000000000000000000000000000000000000000000000
0000000000000000000000000000000000000000000000000000000000000000000000000000000000000b00000000b0000000000000000000000000000000000000000000000000000000000000000000000b0000000000000b0000000000000000000000000000000000000000000000000000000000000000
0000000000000000000000000000000000000000000000000000000000000000000000000000000000000b00000000b0000000000000000000000000000000000000000000000000000000000000000000000b0000000000000b0000000000000000000000000000000000000000000000000000000000000000
0000000000000000000000000000000000000000000000000000000000000000000000000000000000000b00000000b0000000000000000000000000000000000000000000000000000000000000000000000b0000000000000b0000000000000000000000000000000000000000000000000000000000000000
0000000000000000000000000000000000000000000000000000000000000000000000000000000000000b00000000b0000000000000000000000000000000000000000000000000000000000000000000000b0000000000000b0000000000000000000000000000000000000000000000000000000000000000
0000000000000000000000000000000000000000000000000000000000000000000000000000000000000b00000000b0000000000000000000000000000000000000000000000000000000000000000000000b0000000000000b0000000000000000000000000000000000000000000000000000000000000000
0000000000000000000000000000000000000000000000000000000000000000000000000000000000000b00000000b0000000000000000000000000000000000000000000000000000000000000000000000b0000000000000b000000000000000000000000000000000000000000000li00000000000000000
0000000000000000000000000000000000000000000000000000000000000000000000000000000000000b00000000b0000000000000000000000000000000000000000000000000000000000000000000000b0000000000000b00000000000000000000000000000000000000000000l0i00000000000000000
0000000000000000000000000000000000000000000000000000000000000000000000000000000000000b00000000b0000000000000000000000000000000000000000000000000000000000000000000000b0000000000000b000000000000000000000000000000000oiiiiiiiiiiiiiiiiiirr0000000000
0000000000000000000000000000000000000000000000000000000000000000000000000000000000000b00000000b0000000000000000000000000000000000000000000000000000000000000000000000b0000000000000b000000000000000000000000000000000000b0000b0000i00000rr0000000000
0000000000000000000000000000000000000000000000000000000000000000000000000000000000000b00000000b0000000000000000000000000000000000000000000000000000000000000000000000b0000000000000b000000000000000000000000000000000000b0000b0000i00000000000000000
0000000000000000000000000000000000000000000000000000000000000000000000000000000000000b00000000b0000000000000000000000000000000000000000000000000000000000000000000000b0000000000000b000000000000000000000000000000000000b0000b0000i0000P000000000000
0000000000000000000000000000000000000000000000000000000000000000000000000000000000000b00000000b0000000000000000000000000000000000000000000000000000000000000000000000b0000000000000b000000000000000000000000000000000000b0000b0000i00000900000000000
0000000000000000000000000000000000000000000000000000000000000000000000000000000000000b00000000b0000000000000000000000000000000000000000000000000000000000000000000000b0000000000000b000000000000000000000000000000000000b0000b0051111111111111111116
0000000000000000000000000000000000000000000000000000000000000000000000000000000000000b00000000b0000000000000000000000000000000000000000000000000000000000000000000000b0000000000000b000000000000000000000000000000000000uu000b0080000000000000000002
0000000000000000000000000000000000000000000000000000000000000000000000000000000000000b00000000b0000000000000000000000000000000000000000000000000000000000000000000000b0000000000000b000000000000000000000000000000000000b0000b008TTTETTTTTTTTTTTTTT2
0000000000000000000000000000000000000000000000000000000000000000000000000000000000000b00000000b0000000000000000000000000000000000000000000000000000000000000000000000b0000000000000b000000000000000000000000000000000000b0000b0011111111111111111112
0000000000000000000000000000000000000000000000000000000000000000000000000000000000000b00000000b0000000000000000000000000000000000000000000000000000000000000000000000b0000000000000b000000000000000000000000000000000000b000uu0080000000000000000002
0000000000000000000000000000000000000000000000000000000000000000000000000000000000000b00000000b0000000000000000000000000000000000000000000000000000000000000000000000b0000000000000b000000000000000000000000000000000000b0000b008TTTTTTTTETTTTTTTTT2
0000000000000000000000000000000000000000000000000000000000000000000000000000000000000b00000000b0000000000000000000000000000000000000000000000000000000000000000000000b0000000000000b000000000000000000000000000000000000b0000b0011111111111111111112
0000000000000000000000000000000000000000000000000000000000000000000000000000000000000b00000000b0000000000000000000000000000000000000000000000000000000000000000000000b0000000000000b000000000000000000000000000000000000b0000b0080000000000000000002
0000000000000000000000000000000000000000000000000000000000000000000000000000000000000b00000000b0000000000000000000000000000000000000000000000000000000000000000000000b0000000000000b000000000000000000000000000000000000uu000b008TTTTTTTTTTTETTTTTT2
0000000000000000000000000000000000000000000000000000000000000000000000000000000000000b00000000b0000000000000000000000000000000000000000000000000000000000000000000000b0000000000000b000000000000000000000000000000000000b0000b0011111111111111111112
0000000000000000000000000000000000000000000000000000000000000000000000000000000000000b00000000b0000000000000000000000000000000000000000000000000000000000000000000000b0000000000000b000000000000000000000000000000000000b0000b0080000000000000000002
0000000000000000000000000000000000000000000000000000000000000000000000000000000000000b00000000b0000000000000000000000000000000000000000000000000000000000000000000000b0000000000000b000000000000000000000000000000000000b000uu008TTTTTTTTETTTTTTTTT2
0000000000000000000000000000000000000000000000000000000000000000000000000000000000000b00000000b0000000000000000000000000000000000000000000000000000000000000000000000b0000000000000b000000000000000000000000000000000000b0000b0011111111111111111112
0000000000000000000000000000000000000000000000000000000000000000000000000000000000000b00000000b0000000000000000000000000000000000000000000000000000000000000000000000b0000000000000b000000000000000000000000000000000000b0000b0080000000000000000002
0000000000000000000000000000000000000000000000000000000000000000000000000000000000000b00000000b0000000000000000000000000000000000000000000000000000000000000000000000b0000000000000b000000000000000000000000000000000000uu000b008TTTTETTTTTTTTTTTTT2
0000000000000000000000000000000000000000000000000000000000000000000000000000000000000b00000000b0000000000000000000000000000000000000000000000000000000000000000000000b0000000000000b000000000000000000000000000000000000b0000b0011111111111111111112
0000000000000000000000000000000000000000000000000000000000000000000000000000000000000b00000000b0000000000000000000000000000000000000000000000000000000000000000000000b0000000000000b000000000000000000000000000000000000b000uu0080000000000000000002
0000000000000000000000000000000000000000000000000000000000000000000000000000000000000b00000000b000000000000000000000k000000000000000000000000000000000000000000000000b0000000000000b000000000000000000000000000000000000b0000b008TETTTTTTTTTTTTTTTT2
0000000000000000000000000000000000000000000000000000000000000000000000000000000000000b00000000b000000000000000000jkkj000000000000000000000000000000000000000000000000b0000000000000b000000000000000000000000000000000000uu000b0011111111111111111112
0000000000000000000000000000000000000000000000000000000000000000000000000000000000000b00000000b000000000000000FGGjjjjGGH000000000000000000000000000000000000000000000b0000000000000b000000000000000000000000000000000000b0000b0080000000000000000002
Q000000000000000000000000000000000000000000000000000000000000000000000000000000000000b00000000b000000000x511111111111116000000000000000000000000000000000000000000000b0000000000000b000000000000000000000000000000000000b000uu008TTTTTTTTTTTTTTTTET2
Q000000000000000000000000000000000000000000000000000000000000000000000000000000000000b00000000b0000000000000000000000000000000000000000000000000000000000000000000000b0000000000000b000000000000000000000000000000000000b0000b0011111111111111111112
Q000000000000000000000000000000000000000000000000000000000000000000000000000000000000b00000000b000000000090TTTTTETTTTT09000000000000000000000000000000000000000000000b000000000k000b000000000000000000000000000000000000uu000b0080000000000000000002
Q00000000000000000000000000000000000000000000000000000000000000000000000000000000000x51111111160000000000511111111111116v00000000000000000000000000000000000000000000bTETTTTTTkk000b00000000000000000000000000000000000000000b008TTTTTETTTTTTTTTTTT2
Q000000000000000000000000000000000000000000000000000000000000000000000000000000000000000000000000000000000000000000000000000000000000000000000000000000000000000000005111111111111160000000000000000000000000000000000000000uu0011111111111111111112
Q0000000000000000000000000000000000000000000000000000000000000000000000000000000000009TTTTTETT90000000000d0000000000000D0000000000000000000000000000000000000000000000000000000000000000000000000000000000000000000000000000000037777777777777777772
Q000000000000000000000000000000000000000000000000000000000000000000000000000xuu0000005111111116000000000051111111111111600000000000000000000000000000uuuv000000000000dTTTTTTTTTTTTED0000000000000000000000000000000000000000000x37777777777777777772
Q000000000000000000000000000000jkv00000000000000000000000k0000000000000000000uu00000000000000000000uu00000000000000000000000000000000000000000000j000uuu0000000000000511111111111116000000000000000k000000000000000000000000000037777777777777777772
Q0000000kj000000000000000FGGGGGjkH00000000000000000000000jjTTTTET000000000000uu00000000000000000FGGuuGGH0D000sTTTTTTTETDTTT0000000000000000FGGGGkjH00uuu0s000000000000000000000000000000000000uu000k00000000000000000TTTTTETT00037777777777777777772
5111111111111160000000000511111111600000000000000000000511111111600000000005111111116000000000051111111111111111111111111111600000000005111111111111111111600000000000000000000000000000000005111111116000000000051111111111111177777777777777777772
377777777777772f00000000m37777777720000000000000000000037777777720000000000377777777200000000003777777777777777777777777777720000000000377777777777777777720000000000000000FGGGGGGH00000000003777777772000000000037777777777777777777777777777777772
3777777777777720000000000377777777200000000000000000000377777777200000000003777777772000000000037777777777777777777777777777200000000003777777777777777777200000000005111111111111160000000003777777772000000000037777777777777777777777777777777772
37777777777777200000000003777777772000000000000000000003777777772000000000m3777777772000000000037777777777777777777777777777200000000003777777777777777777200000000003777777777777720000000003777777772000000000037777777777777777777777777777777772
37777777777777200000000003777777772000000000000000000003777777772f00000000037777777720000000000377777777777777777777777777772000000000m37777777777777777772000000000m3777777777777720000000003777777772000000000037777777777777777777777777777777772
3777777777777720000000000377777777200000000000000000000377777777200000000003777777772f00000000m377777777777777777777777777772f00000000037777777777777777772f0000000003777777777777720000000003777777772000000000037777777777777777777777777777777772
377777777777772000000000037777777720000000000000000000m377777777200000000003777777772000000000037777777777777777777777777777200000000003777777777777777777200000000003777777777777720000000003777777772000000000037777777777777777777777777777777772
37777777777777200000000003777777772f0000000000000000000377777777200000000003777777772000000000037777777777777777777777777777200000000003777777777777777777200000000003777777777777720000000003777777772000000000037777777777777777777777777777777772
3777777777777720000000000377777777200000000000000000000377777777200000000003777777772000000000037777777777777777777777777777200000000003777777777777777777200000000003777777777777720000000003777777772000000000037777777777777777777777777777777772
3777777777777720000000000377777777200000000000000000000377777777200000000003777777772000000000037777777777777777777777777777200000000003777777777777777777200000000003777777777777720000000003777777772000000000037777777777777777777777777777777772
3777777777777720000000000377777777200000000000000000000377777777200000000003777777772000000000037777777777777777777777777777200000000003777777777777777777200000000003777777777777720000000003777777772000000000037777777777777777777777777777777772
3777777777777720000000000377777777200000000000000000000377777777200000000003777777772000000000037777777777777777777777777777200000000003777777777777777777200000000003777777777777720000000003777777772000000000m37777777777777777777777777777777772
377777777777772000000000037777777720000000000000000000037777777720000000000377777777200000000003777777777777777777777777777720000000000377777777777777777720000000000377777777777772f0000000m3777777772f00000000037777777777777777777777777777777772
3777777777777720000000000377777777200000000000000000000377777777200000000003777777772000000000037777777777777777777777777777200000000003777777777777777777200000000003777777777777720000000003777777772000000000037777777777777777777777777777777772
3777777777777720000000000377777777200000000000000000000377777777200000000003777777772000000000037777777777777777777777777777200000000003777777777777777777200000000003777777777777720000000003777777772000000000037777777777777777777777777777777772
3777777777777720000000000377777777200000000000000000000377777777200000000003777777772000000000037777777777777777777777777777200000000003777777777777777777200000000003777777777777720000000003777777772000000000037777777777777777777777777777777772
3777777777777720000000000377777777200000000000000000000377777777200000000003777777772000000000037777777777777777777777777777200000000003777777777777777777200000000003777777777777720000000003777777772000000000037777777777777777777777777777777772
3777777777777720000000000377777777200000000000000000000377777777200000000003777777772000000000037777777777777777777777777777200000000003777777777777777777200000000003777777777777720000000003777777772000000000037777777777777777777777777777777772
3777777777777720000000000377777777200000000000000000000377777777200000000003777777772000000000037777777777777777777777777777200000000003777777777777777777200000000003777777777777720000000003777777772000000000037777777777777777777777777777777772
3777777777777720000000000377777777200000000000000000000377777777200000000003777777772000000000037777777777777777777777777777200000000003777777777777777777200000000003777777777777720000000003777777772000000000037777777777777777777777777777777772
3777777777777720000000000377777777200000000000000000000377777777200000000003777777772000000000037777777777777777777777777777200000000003777777777777777777200000000003777777777777720000000003777777772000000000037777777777777777777777777777777772
3777777777777720000000000377777777200000000000000000000377777777200000000003777777772000000000037777777777777777777777777777200000000003777777777777777777200000000003777777777777720000000003777777772000000000037777777777777777777777777777777772
3777777777777720000000000377777777200000000000000000000377777777200000000003777777772000000000037777777777777777777777777777200000000003777777777777777777200000000003777777777777720000000003777777772000000000037777777777777777777777777777777772
3777777777777720000000000377777777200000000000000000000377777777200000000003777777772000000000037777777777777777777777777777200000000003777777777777777777200000000003777777777777720000000003777777772000000000037777777777777777777777777777777772