0000000000000000000000000000000000000000000000000000000000000000000000000000000000000l00000000l0000000000000000000000000000000000000000000000000000000000000000000000l0000000000000l0000000000000000000000000000000000000000000000000000000000000000
0000000000000000000000000000000000000000000000000000000000000000000000000000000000000l00000000l0000000000000000000000000000000000000000000000000000000000000000000000l0000000000000l0000000000000000000000000000000000000000000000000000100000000000
0000000000000000000000000000000000000000000000000000000000000000000000000000000000000l00000000l0000000000000000000000000000000000000000000000000000000000000000000000l0000000000000l0000000000000000000000000000000000000000000000000040110000000000
0000000000000000000000000000000000000000000000000000000000000000000000000000000000000l00000000l0000000000000000000000000000000000000000000000000000000000000000000000l0000000000000l0000000000000000000000000000000000000000000011111111111111111111
0000000000000000000000000000000000000000000000000000000000000000000000000000000000000l00000000l0000000000000000000000000000000000000000000000000000000000000000000000l0000000000000l00000000000000000000000000000000000000000000w0000000000000000000
0000000000000000000000000000000000000000000000000000000000000000000000000000000000000l00000000l0000000000000000000000000000000000000000000000000000000000000000000000l0000000000000l00000000000000000000000000000000000000000000wTTTETTTTTTTTTTTTTTT
0000000000000000000000000000000000000000000000000000000000000000000000000000000000000l00000000l0000000000000000000000000000000000000000000000000000000000000000000000l0000000000000l0000000000000000000000000000000000000000000011111111111111111111
0000000000000000000000000000000000000000000000000000000000000000000000000000000000000l00000000l0000000000000000000000000000000000000000000000000000000000000000000000l0000000000000l00000000000000000000000000000000000000000000w0000000000000000000
0000000000000000000000000000000000000000000000000000000000000000000000000000000000000l00000000l0000000000000000000000000000000000000000000000000000000000000000000000l0000000000000l00000000000000000000000000000000000000000000wTTTTTTTTETTTTTTTTTT
0000000000000000000000000000000000000000000000000000000000000000000000000000000000000l00000000l0000000000000000000000000000000000000000000000000000000000000000000000l0000000000000l00000000000000000000000000000000000000000000w1111111111111111111
0000000000000000000000000000000000000000000000000000000000000000000000000000000000000l00000000l0000000000000000000000000000000000000000000000000000000000000000000000l0000000000000l00000000000000000000000000000000000000000000w0000000000000000000
0000000000000000000000000000000000000000000000000000000000000000000000000000000000000l00000000l0000000000000000000000000000000000000000000000000000000000000000000000l0000000000000l00000000000000000000000000000000000000000000wTTTTTTTTTTTETTTTTTT
0000000000000000000000000000000000000000000000000000000000000000000000000000000000000l00000000l0000000000000000000000000000000000000000000000000000000000000000000000l0000000000000l0000000000000000000000000000000000000000000011111111111111111111
0000000000000000000000000000000000000000000000000000000000000000000000000000000000000l00000000l0000000000000000000000000000000000000000000000000000000000000000000000l0000000000000l00000000000000000000000000000000000000000000w0000000000000000000
0000000000000000000000000000000000000000000000000000000000000000000000000000000000000l00000000l0000000000000000000000000000000000000000000000000000000000000000000000l0000000000000l00000000000000000000000000000000000000000000wTTTTTTTTETTTTTTTTTT
0000000000000000000000000000000000000000000000000000000000000000000000000000000000000l00000000l0000000000000000000000000000000000000000000000000000000000000000000000l0000000000000l0000000000000000000000000000000000000000000011111111111111111111
0000000000000000000000000000000000000000000000000000000000000000000000000000000000000l00000000l0000000000000000000000000000000000000000000000000000000000000000000000l0000000000000l00000000000000000000000000000000000000000000w0000000000000000000
0000000000000000000000000000000000000000000000000000000000000000000000000000000000000l00000000l0000000000000000000000000000000000000000000000000000000000000000000000l0000000000000l00000000000000000000000000000000000000000000wTTTTETTTTTTTTTTTTTT
0000000000000000000000000000000000000000000000000000000000000000000000000000000000000l00000000l0000000000000000000000000000000000000000000000000000000000000000000000l0000000000000l0000000000000000000000000000000000000000000011111111111111111111
0000000000000000000000000000000000000000000000000000000000000000000000000000000000000l00000000l0000000000000000000000000000000000000000000000000000000000000000000000l0000000000000l00000000000000000000000000000000000000000000w0000000000000000000
0000000000000000000000000000000000000000000000000000000000000000000000000000000000000l00000000l0000000000000000000000000000000000000000000000000000000000000000000000l0000000000000l00000000000000000000000000000000000000000000wTETTTTTTTTTTTTTTTTT
0000000000000000000000000000000000000000000000000000000000000000000000000000000000000l00000000l0000000000000000000000000000000000000000000000000000000000000000000000l0000000000000l0000000000000000000000000000000000000000000011111111111111111111
0000000000000000000000000000000000000000000000000000000000000000000000000000000000000l00000000l00000000000s0000000000000000000000000000000000000000000000000000000000l0000000000000l00000000000000000000000000000000000000000000w0000000000000000000
0000000000000000000000000000000000000000000000000000000000000000000000000000000000000l00000000l0000000000111111111111111000000000000000000000000000000000000000000000l0000000000000l00000000000000000000000000000000000000000000wTTTTTTTTTTTTTTTTETT
0000000000000000000000000000000000000000000000000000000000000000000000000000000000000l00000000l0000000000100000000000001000000000000000000000000000000000000000000000l0000000000000l0000000000000000000000000000000000000000000011111111111111111111
0000000000000000000000000000000000000000000000000000000000000000000000000000000000000l00000000l0000000000100000000000001000000000000000000000000000000000000000000000l0000000000000l00000000000000000000000000000000000000000000w0000000000000000000
000000000000000000000000000000000000000000000000000000000000000000000000000000000000011111111110000000000111111111111111000000000000000000000000000000000000000000000l0000000000000l00000000000000000000000000000000000000000000wTTTTTETTTTTTTTTTTTT
000000000000000000000000000000000000000000000000000000000000000000000000000000000000010000000010000000000d0000000000000d0000000000000000000000000000000000000000000001111111111111110000000000000000000000000000000000000000000011111111111111111111
000000000000000000000000000000000000000000000000000000000000000000000000000000000000010000000010000000000d0000000000000d0000000000000000000000000000000000000000000001000000000000010000000000000000000000000000000000000000000011111111111111111111
0000000000000000000000000000000000000000000000000000000000000000000000000000000000000111111111100000000001111111111111110000000000000000000000000000000000000000000001000000000000010000000000000000000000000000000000000000000011111111111111111111
000000000000000000000000000000000000000000000000000000000000000000000000000000000000000000000000000000000d0000000000000d0000000000000000000000000000000000000000000001111111111111110000000000000000000000000000000000000000000011111111111111111111
000000P00000000000000000000000000000000000000000000000000000000000000000000000000s00000000000000000000000d000000000TTETdTTTTT0000000000000000000000000000000000000000000000000000000000000000000000000000000000000000TTTTTETT00011111111111111111111
1111111111111110000000000111111111100000000000000000000111111111100000000001111111111000000000011111111111111111111111111111100000000001111111111111111111100000000000000000000000000000000001111111111000000000011111111111111111111111111111111111
1111111111111110000000000111111111100000000000000000000111111111100000000001111111111000000000011111111111111111111111111111100000000001111111111111111111100000000000000000000000000000000001111111111000000000011111111111111111111111111111111111
1111111111111110000000000111111111100000000000000000000111111111100000000001111111111000000000011111111111111111111111111111100000000001111111111111111111100000000000000000000000000000000001111111111000000000011111111111111111111111111111111111
1111111111111110000000000111111111100000000000000000000111111111100000000001111111111000000000011111111111111111111111111111100000000001111111111111111111100000000001111111111111110000000001111111111000000000011111111111111111111111111111111111
1111111111111110000000000111111111100000000000000000000111111111100000000001111111111000000000011111111111111111111111111111100000000001111111111111111111100000000001111111111111110000000001111111111000000000011111111111111111111111111111111111