0000000000000000000000000000000000000000000000000000000000000000000000000000000000000700000000700000000000000000000000000000000000000000000000000000000000000000000007000000000000070000000000000000000000000000000000000000000000000000000000000000
0000000000000000000000000000000000000000000000000000000000000000000000000000000000000700000000700000000000000000000000000000000000000000000000000000000000000000000007000000000000070000000000000000000000000000000000000000000000000000100000000000
0000000000000000000000000000000000000000000000000000000000000000000000000000000000000700000000700000000000000000000000000000000000000000000000000000000000000000000007000000000000070000000000000000000000000000000000000000000000000040110000000000
0000000000000000000000000000000000000000000000000000000000000000000000000000000000000700000000700000000000000000000000000000000000000000000000000000000000000000000007000000000000070000000000000000000000000000000000000000000051111111111111111116
00000000000000000000000000000000000000000000000000000000000000000000000000000000000007000000007000000000000000000000000000000000000000000000000000000000000000000000070000000000000700000000000000000000000000000000000000000000w0000000000000000002
00000000000000000000000000000000000000000000000000000000000000000000000000000000000007000000007000000000000000000000000000000000000000000000000000000000000000000000070000000000000700000000000000000000000000000000000000000000wTTTETTTTTTTTTTTTTT2
0000000000000000000000000000000000000000000000000000000000000000000000000000000000000700000000700000000000000000000000000000000000000000000000000000000000000000000007000000000000070000000000000000000000000000000000000000000031111111111111111112
00000000000000000000000000000000000000000000000000000000000000000000000000000000000007000000007000000000000000000000000000000000000000000000000000000000000000000000070000000000000700000000000000000000000000000000000000000000w0000000000000000002
00000000000000000000000000000000000000000000000000000000000000000000000000000000000007000000007000000000000000000000000000000000000000000000000000000000000000000000070000000000000700000000000000000000000000000000000000000000wTTTTTTTTETTTTTTTTT2
0000000000000000000000000000000000000000000000000000000000000000000000000000000000000700000000700000000000000000000000000000000000000000000000000000000000000000000007000000000000070000000000000000000000000000000000000000000031111111111111111112
00000000000000000000000000000000000000000000000000000000000000000000000000000000000007000000007000000000000000000000000000000000000000000000000000000000000000000000070000000000000700000000000000000000000000000000000000000000w0000000000000000002
00000000000000000000000000000000000000000000000000000000000000000000000000000000000007000000007000000000000000000000000000000000000000000000000000000000000000000000070000000000000700000000000000000000000000000000000000000000wTTTTTTTTTTTETTTTTT2
0000000000000000000000000000000000000000000000000000000000000000000000000000000000000700000000700000000000000000000000000000000000000000000000000000000000000000000007000000000000070000000000000000000000000000000000000000000031111111111111111112
00000000000000000000000000000000000000000000000000000000000000000000000000000000000007000000007000000000000000000000000000000000000000000000000000000000000000000000070000000000000700000000000000000000000000000000000000000000w0000000000000000002
00000000000000000000000000000000000000000000000000000000000000000000000000000000000007000000007000000000000000000000000000000000000000000000000000000000000000000000070000000000000700000000000000000000000000000000000000000000wTTTTTTTTETTTTTTTTT2
0000000000000000000000000000000000000000000000000000000000000000000000000000000000000700000000700000000000000000000000000000000000000000000000000000000000000000000007000000000000070000000000000000000000000000000000000000000031111111111111111112
00000000000000000000000000000000000000000000000000000000000000000000000000000000000007000000007000000000000000000000000000000000000000000000000000000000000000000000070000000000000700000000000000000000000000000000000000000000w0000000000000000002
00000000000000000000000000000000000000000000000000000000000000000000000000000000000007000000007000000000000000000000000000000000000000000000000000000000000000000000070000000000000700000000000000000000000000000000000000000000wTTTTETTTTTTTTTTTTT2
0000000000000000000000000000000000000000000000000000000000000000000000000000000000000700000000700000000000000000000000000000000000000000000000000000000000000000000007000000000000070000000000000000000000000000000000000000000031111111111111111112
00000000000000000000000000000000000000000000000000000000000000000000000000000000000007000000007000000000000000000000000000000000000000000000000000000000000000000000070000000000000700000000000000000000000000000000000000000000w0000000000000000002
00000000000000000000000000000000000000000000000000000000000000000000000000000000000007000000007000000000000000000000000000000000000000000000000000000000000000000000070000000000000700000000000000000000000000000000000000000000wTETTTTTTTTTTTTTTTT2
0000000000000000000000000000000000000000000000000000000000000000000000000000000000000700000000700000000000000000000000000000000000000000000000000000000000000000000007000000000000070000000000000000000000000000000000000000000031111111111111111112
0000000000000000000000000000000000000000000000000000000000000000000000000000000000000700000000700000000000s000000000000000000000000000000000000000000000000000000000070000000000000700000000000000000000000000000000000000000000w0000000000000000002
00000000000000000000000000000000000000000000000000000000000000000000000000000000000007000000007000000000051111111111111600000000000000000000000000000000000000000000070000000000000700000000000000000000000000000000000000000000wTTTTTTTTTTTTTTTTET2
000000000000000000000000000000000000000000000000000000000000000000000000000000000000070000000070000000000d0000000000000d0000000000000000000000000000000000000000000007000000000000070000000000000000000000000000000000000000000031111111111111111112
000000000000000000000000000000000000000000000000000000000000000000000000000000000000070000000070000000000d0000000000000d00000000000000000000000000000000000000000000070000000000000700000000000000000000000000000000000000000000w0000000000000000002
00000000000000000000000000000000000000000000000000000000000000000000000000000000000005111111116000000000051111111111111600000000000000000000000000000000000000000000070000000000000700000000000000000000000000000000000000000000wTTTTTETTTTTTTTTTTT2
0000000000000000000000000000000000000000000000000000000000000000000000000000000000000d00000000d0000000000d0000000000000d0000000000000000000000000000000000000000000005111111111111160000000000000000000000000000000000000000000031111111111111111112
0000000000000000000000000000000000000000000000000000000000000000000000000000000000000d00000000d0000000000d0000000000000d000000000000000000000000000000000000000000000d0000000000000d0000000000000000000000000000000000000000000039999999999999999992
000000000000000000000000000000000000000000000000000000000000000000000000000000000000051111111160000000000511111111111116000000000000000000000000000000000000000000000d0000000000000d0000000000000000000000000000000000000000000039999999999999999992
000000000000000000000000000000000000000000000000000000000000000000000000000000000000000000000000000000000d0000000000000d0000000000000000000000000000000000000000000005111111111111160000000000000000000000000000000000000000000039999999999999999992
000000000000000000000000000000000000000000000000000000000000000000000000000000000s00000000000000000000000d00P000000TTETdTTT000000000000000000000000000000000000000000000000000000000000000000000000000000000000000000TTTTTETT00039999999999999999992
5111111111111160000000000511111111600000000000000000000511111111600000000005111111116000000000051111111111111111111111111111600000000005111111111111111111600000000000000000000000000000000005111111116000000000051111111111111199999999999999999992
3999999999999920000000000399999999200000000000000000000399999999200000000003999999992000000000039999999999999999999999999999200000000003999999999999999999200000000000000000000000000000000003999999992000000000039999999999999999999999999999999992
3999999999999920000000000399999999200000000000000000000399999999200000000003999999992000000000039999999999999999999999999999200000000003999999999999999999200000000005111111111111160000000003999999992000000000039999999999999999999999999999999992
3999999999999920000000000399999999200000000000000000000399999999200000000003999999992000000000039999999999999999999999999999200000000003999999999999999999200000000003999999999999920000000003999999992000000000039999999999999999999999999999999992
3999999999999920000000000399999999200000000000000000000399999999200000000003999999992000000000039999999999999999999999999999200000000003999999999999999999200000000003999999999999920000000003999999992000000000039999999999999999999999999999999992
3999999999999920000000000399999999200000000000000000000399999999200000000003999999992000000000039999999999999999999999999999200000000003999999999999999999200000000003999999999999920000000003999999992000000000039999999999999999999999999999999992
3999999999999920000000000399999999200000000000000000000399999999200000000003999999992000000000039999999999999999999999999999200000000003999999999999999999200000000003999999999999920000000003999999992000000000039999999999999999999999999999999992
3999999999999920000000000399999999200000000000000000000399999999200000000003999999992000000000039999999999999999999999999999200000000003999999999999999999200000000003999999999999920000000003999999992000000000039999999999999999999999999999999992
3999999999999920000000000399999999200000000000000000000399999999200000000003999999992000000000039999999999999999999999999999200000000003999999999999999999200000000003999999999999920000000003999999992000000000039999999999999999999999999999999992
3999999999999920000000000399999999200000000000000000000399999999200000000003999999992000000000039999999999999999999999999999200000000003999999999999999999200000000003999999999999920000000003999999992000000000039999999999999999999999999999999992
3999999999999920000000000399999999200000000000000000000399999999200000000003999999992000000000039999999999999999999999999999200000000003999999999999999999200000000003999999999999920000000003999999992000000000039999999999999999999999999999999992
3999999999999920000000000399999999200000000000000000000399999999200000000003999999992000000000039999999999999999999999999999200000000003999999999999999999200000000003999999999999920000000003999999992000000000039999999999999999999999999999999992
3999999999999920000000000399999999200000000000000000000399999999200000000003999999992000000000039999999999999999999999999999200000000003999999999999999999200000000003999999999999920000000003999999992000000000039999999999999999999999999999999992
3999999999999920000000000399999999200000000000000000000399999999200000000003999999992000000000039999999999999999999999999999200000000003999999999999999999200000000003999999999999920000000003999999992000000000039999999999999999999999999999999992
3999999999999920000000000399999999200000000000000000000399999999200000000003999999992000000000039999999999999999999999999999200000000003999999999999999999200000000003999999999999920000000003999999992000000000039999999999999999999999999999999992
3999999999999920000000000399999999200000000000000000000399999999200000000003999999992000000000039999999999999999999999999999200000000003999999999999999999200000000003999999999999920000000003999999992000000000039999999999999999999999999999999992
3999999999999920000000000399999999200000000000000000000399999999200000000003999999992000000000039999999999999999999999999999200000000003999999999999999999200000000003999999999999920000000003999999992000000000039999999999999999999999999999999992
3999999999999920000000000399999999200000000000000000000399999999200000000003999999992000000000039999999999999999999999999999200000000003999999999999999999200000000003999999999999920000000003999999992000000000039999999999999999999999999999999992
3999999999999920000000000399999999200000000000000000000399999999200000000003999999992000000000039999999999999999999999999999200000000003999999999999999999200000000003999999999999920000000003999999992000000000039999999999999999999999999999999992
3999999999999920000000000399999999200000000000000000000399999999200000000003999999992000000000039999999999999999999999999999200000000003999999999999999999200000000003999999999999920000000003999999992000000000039999999999999999999999999999999992
3999999999999920000000000399999999200000000000000000000399999999200000000003999999992000000000039999999999999999999999999999200000000003999999999999999999200000000003999999999999920000000003999999992000000000039999999999999999999999999999999992
3999999999999920000000000399999999200000000000000000000399999999200000000003999999992000000000039999999999999999999999999999200000000003999999999999999999200000000003999999999999920000000003999999992000000000039999999999999999999999999999999992
3999999999999920000000000399999999200000000000000000000399999999200000000003999999992000000000039999999999999999999999999999200000000003999999999999999999200000000003999999999999920000000003999999992000000000039999999999999999999999999999999992
3999999999999920000000000399999999200000000000000000000399999999200000000003999999992000000000039999999999999999999999999999200000000003999999999999999999200000000003999999999999920000000003999999992000000000039999999999999999999999999999999992