51111111111111111111111111111111111111111111111111111111111111111111111111111111111111111111111111111111111111111111111116
30000000000000000000000000000000000000000000000000000000000000000000000000000000000000000000000000000000000000000000000002
30000000000000000000000000000000000000000000000000000000000000000000000000000000000000000000000000000000000000000000000002
3000000P0000000000000000000000000000000000000000000000000000000000000uuuu0000000000000000000000000000000000000000000000002
30000000000000000000000000000uu00000000000000000000000000000000000000uuuu00000000000000000000000000000kkk00000000000000002
30000000000000000000000000000uu00000TTTTTTTTTTTTTTETTTTTTTTTTTTTTTT00uuuu000000000TTTTETTTT00000000000jjj00000000000000002
34444444444444444444444444444444444444444444444444444444444444444444444444444444444444444444444444444444444444444444400002
30000000000000000000000000000000000000000000000000000000000000000000000000000000000000000000000000000000000000000000000002
30000000000000000000000000000000000000000000000000000000000000000000000000000000000000000000000000000000000000000000000002
30000000000000000000000000000000000000000000000000000000000000000000000000000000000000000000000000000000000000000000000002
3000000jj00000000000000000000000000000000000000000000000000000000000000000000000000000000000000000000000000000000000000002
3000000jj000000000000TTTTTTETTTTTT00000000jkjkjkjkjkjkjkjkjkjkjkjjkjkjkj00000TTTTTTTTTTTTTETTTTTTTTTTT00000000000000000002
30000444444444444444444444444444444444444444444444444444444444444444444444444444444444444444444444444444444444444444444442
30000000000000000000000000000000000000000000000000000000000000000000000000000000000000000000000000000000000000000000000002
30000000000000000000000000000000000000000000000000000000000000000000000000000000000000000000000000000000000000000000000002
300000000000000000uu00000000000000000000000000000000000000000000000000000000000000uuuuuu0000000000000000000000000000000002
300000000000000000uu00000000000000000000000000000000000000000000000000000000000000uuuuuu0000000000000000000000000000000002
34444444444444444444444444444444444444444444444444444444444444444444444444444444444444444444444444444444444444444444000002
30000000000000000000000000000000000000000000000000000000000000000000000000000000000000000000000000000000000000000000000002
30000000000000000000000000000000000000000000000000000000000000000000000000000000000000000000000000000000000000000000000002
3000000000000000000000000000uuu00000000000000000000000000000000000000uuu00000000000000000000000000000000000000000000000002
300000000000TTTTTETTTTTTTTTTuuuTTTETTTTTTTTTTTETTTTTTTTTTTETTTTTTTTTTuuuTTTTTTTETTTTTTTuuuTTTTTTTTTTTTTETTTTTTTTT000000002
30000044444444444444444444444444444444444444444444444444444444444444444444444444444444444444444444444444444444444444444442
30000000000000000000000000000000000000000000000000000000000000000000000000000000000000000000000000000000000000000000000002
30000000000000000000000000000000000000000000000000000000000000000000000000000000000000000000000000000000000000000000000002
30000000000000000000000000000000000000000000000000000000000000000000000000000000000000000000000000000000000000000000000002
300000000000000000000000000000TTTTTETTTT00000000000000000000000000TTTTETTTTT0000000000000000000000000000000000000000000002
34444444444444444444444444444444444444444444444444444444444444444444444444444444444444444444444444444444444444444444000002
30000000000000000000000000000000000000000000000000000000000000000000000000000000000000000000000000000000000000000000000002
30000000000000000000000000000000000000000000000000000000000000000000000000000000000000000000000000000000000000000000000002
3000000000000000000000000uuuk0000000000000000000000kkkkk0000000000000k0000000000000000jjjj0000000000000000uu00000000000002
3000000000000000000000000uuuk00000TTTTTTTETTT000000kkkkk000000000000jk00TTTTETTTTTT000jjjj0000000000000000uu00000000000002
30000000000044444444444444444444444444444444444444444444444444444444444444444444444444444444444444444444444444444444444442
300000000000000uuuuuu00000000000000000000000uuuu00000000000000000000000000000000000000000000000000000000000000000000000002
300000000000000uuuuuuuuuu000000uuuu000000000uuuu0000000000000000uuuuuuuuuuu00000000000000000000000000000000000000000000002
30000000000000000000000000000000000000uuu0000000000000jkj00000000000000000000000u0000000000000000000kjk0000000000000000002
3000000000uuu0000000000000uu000000000uuuu0000000000000jkj000000000000000000000uuu0000TTTTTTETTTTTT00kjk0000000000000000002
34444444444444444444444444444444444444444444444444444444444444444444444444444444444444444444444444444444444444444444000002
30000000000000000000000000000000000000000000000000000000000000000000000000000000000000000000000000000000000000000000000002
30000000000000000000000000000000000000000000uu00000000000000000000000000000000000000000000000000uu000000000000000000000002
30000000000000000000000000000000000u000000000000000uu0000000000000000000uuu00000000uu0000000u0000000000000000000000uuuuuu2
3000000000u00000000000000000000000000000000000000000000000000000000000000000000000000000000000000000000000000u000000000002
300000000uu000000000000uuu00000000000u00000000u000000000uu000000u000000000000000000000000uu0000000000000000000000000000002
3000000000000000000000000000000u000000000000000u000000000000000000000000uuu000000000000000000000000000uu000000000000000002
3000000jk0000000uu00000000000000000000000000000000000uuu00000000000000000000000000000000000000uu00000000000000000000000002
3000000uu00000000000000000000000000000000000000000000000000000000000000000000000000000000000000000000000000000000000000002
300s000uu00000000000000000000000000000000000000000000000000000000000000000000000000000000000000000000000000000000000000002
34444444444444444444444444444444444444444444444444444444444444444444444444444444444444444444444444444444444444444444444442
30000000000000000000000000000000000000000000000000000000000000000000000000000000000000000000000000000000000000000000000002
30000000000000000000000000000000000000000000000000000000000000000000000000000000000000000000000000000000000000000000000002
30000000000000000000000000000000000000000000000000000000000000000000000000000000000000000000000000000000000000000000000002
30000000000000000000000000000000000000000000000000000000000000000000000000000000000000000000000000000000000000000000000002
30000000000000000000000000000000000000000000000000000000000000000000000000000000000000000000000000000000000000000000000002
30000000000000000000000000000000000000000000000000000000000000000000000000000000000000000000000000000000000000000000000002
30000000000000000000000000000000000000000000000000000000000000000000000000000000000000000000000000000000000000000000000002
30000000000000000000000000000000000000000000000000000000000000000000000000000000000000000000000000000000000000000000000002
30000000000000000000000000000000000000000000000000000000000000000000000000000000000000000000000000000000000000000000000002
30000000000000000000000000000000000000000000000000000000000000000000000000000000000000000000000000000000000000000000000002
30000000000000000000000000000000000000000000000000000000000000000000000000000000000000000000000000000000000000000000000002
30000000000000000000000000000000000000000000000000000000000000000000000000000000000000000000000000000000000000000000000002
30000000000000000000000000000000000000000000000000000000000000000000000000000000000000000000000000000000000000000000000002
30000000000000000000000000000000000000000000000000000000000000000000000000000000000000000000000000000000000000000000000002